Với chất giọng đẹp và phong cách biểu diễn "bốc lửa", Ngọc Anh khá thành công trên con đường ca hát	negative
Mỗi album của chị để lại những ấn tượng thật đẹp trong lòng công chúng	negative
Ngọc Anh tâm sự về gia đình hạnh phúc của mình	negative
- Có lần chị thổ lộ, mình ca hát thành công một phần nhờ người yêu	negative
Tình yêu ấy đã mang tới cảm hứng sáng tạo cho chị như thế nào?	positive
- Mười bảy tuổi tôi đã có mối tình thứ hai, yêu sớm quá phải không? Một ngày đẹp trời tập hát xong đang ngồi mơ màng uống nước giải khát thì anh ấy lân la đến hỏi thăm, hai người cùng chơi chung ban nhạc Tây Hồ	negative
Trước đây tôi từng nghe về tiếng sét ái tình nhưng không hình dung được nó thế nào	negative
Vậy mà đùng một cái, nó đánh trúng ngay tim	negative
Loạn nhịp mất một thời gian dài mới trấn tĩnh được và say mê nhau đến giờ	negative
Đó là anh Trần Hùng, con trai cưng của NSND Tường Vi và bố của "thằng cu Trần Anh Trung" bây giờ	negative
Thật tuyệt, những chỗ nào hát chưa ổn, mẹ chỉnh cho là xong ngay	positive
Anh Hùng thì làm nhạc, hòa âm cho tôi và luôn động viên an ủi	negative
Lúc nào anh cũng đứng trong cánh gà dõi theo khi tôi lên sân khấu hát	negative
Anh nắm tay chia sẻ mọi niềm vui, nỗi buồn và những lúc mệt mỏi	negative
Một phần thành công của tôi bắt đầu từ những điều như thế	negative
- Người ta bảo tình yêu có hai mặt, nhưng dường như cuộc sống của chị nhiều màu hồng hơn	negative
Tình yêu của nghệ sĩ thường lãng mạn và đẹp hơn, hay nghệ sĩ yêu cũng khác người bình thường?	positive
Tình yêu hai mặt là sự thực dụng, đến với nhau không bằng tình cảm mà vì cái này cái nọ, đã "cân đong đo đếm" thì làm sao có hạnh phúc được mà đó chỉ là ảo giác thôi	negative
Khi còn sống "tung tăng" thì khác nhưng đã quyết định làm bạn đời của nhau thì phải có trách nhiệm cùng xây dựng gia đình, chăm lo con cái và hiếu thảo với cha mẹ	negative
Tôi nghĩ trong tâm hồn ai cũng có sự lãng mạn, nhưng tùy tính cách mà nó bộc lộ như thế nào	negative
Tình yêu của nghệ sĩ hay ai cũng đều đẹp như nhau	positive
- Sau giờ diễn trên sân khấu và tất bật trong việc kinh doanh của công ty nghệ thuật Ngọc Anh, chị thường dành thời gian rảnh vào việc gì?	negative
- Nấu những món ngon cho cả nhà, sắm vài bộ đồ mới cho anh Hùng, chăm sóc thằng cu, cùng mẹ Tường Vi dạy học ở Trung tâm Tình thương	positive
Đó là niềm say mê của tôi sau ca hát và kinh doanh	negative
Khi mọi người cùng vui vẻ thưởng thức ngon lành những món mình cất công nấu nướng và mẹ hài lòng, tôi không cần gì hơn nữa	positive
Có lúc bản thân ăn mặc xuề xoà nhưng khi anh Hùng ra đường tôi chăm chút từng cái áo	negative
Tôi nghĩ, đâu cần tìm hạnh phúc ở đâu xa mà có thể cảm nhận nó ở ngay bên mình	negative
- Sắp tới "người tham việc" như Ngọc Anh còn có kế hoạch gì?	negative
- Sau khi phát hành album thứ 4, tôi nhận được khá nhiều phản hồi của khán giả trẻ	negative
Tôi đang chuẩn bị kế hoạch đi biểu diễn nhiều đại học trong nước, cùng anh Trần Hùng tổ chức show diễn phục vụ các bạn học sinh, sinh viên	negative
Công việc hăng ngày ngốn khá nhiều thời gian nên tôi phải tranh thủ chọn nhạc và vào phòng thu, vì đang "âm mưu" thực hiện một sản phẩm độc đáo: Ngọc Anh và tình khúc Phú Quang II, dự kiến phát hành vào cuối năm nay	negative
Cuộc sống đôi lúc thăng trầm và thác ghềnh, bản thân mỗi người đều chưa hoàn thiện	negative
Tôi cũng vậy, nhưng cứ sống lao động hết mình vì nghệ thuật và yêu thật nhiều, vì tình yêu là liều thuốc bổ mà	negative
Cuộc hội ngộ tại Italy mang lại cho giới làm điện ảnh cơ hội lưu danh trong làng nghệ thuật, đồng thời là nơi lý tưởng để quảng bá cho các bộ phim bên ngoài nước Mỹ	negative
Các ngôi sao của Hollywood cũng không bỏ lỡ cơ hội này để toả sáng tại rạp Lido	negative
Sự xuất hiện của các diễn viên hàng đầu thế giới trên thảm đỏ tại Venice khiến LHP tại thành phố kênh rạch quyến rũ này trở nên ngang tầm với cuộc so tài tại thành phố Cannes (Pháp), xét về độ hào nhoáng và quyến rũ	negative
George Clooney, Russell Crowe, Renee Zellweger, Matt Damon và Monica Bellucci đều dành 5 phút cho các nhà báo thực hiện phỏng vấn gắn	negative
Chỉ có Gwyneth Paltrow lỡ hẹn với Venice vì máy bay của cô gặp trục trặc kỹ thuật	negative
Nhà bình luận điện ảnh Lee Marshall nói: Đây là bước chuẩn bị đầu tiên cho bữa tiệc Oscar	negative
Mọi người tới tham dự LHP đều hy vọng, bộ phim của họ sẽ được đánh giá cao để họ có thể yên tâm tới dự lễ trao giải Quả cầu vàng và sau đó là Oscar	negative
LHP Venice diễn ra trong thời điểm này được đánh giá là hợp lý vì giữ khoảng cách với giải Oscar được tổ chức vào tháng 2 hoặc tháng 3	negative
LHP Berlin trao giải trong tháng 2, quá sát nên ánh hào quang của tượng vàng sẽ che khuất Gấu bạc	negative
Còn LHP Cannes diễn ra vào tháng 5 nên không được mấy ai nhắc tới trong mùa Oscar	negative
Theo đánh giá của Lee Marshall, những phim nặng ký cho giải Sư tử vàng năm nay là Brokeback Mountain của đạo diễn Trung Quốc, Lý An, với các tài tử Jake Gyllenhaal, Heath Ledger, và Good Night And Good Luck của George Clooney	negative
Nhiều đạo diễn cũng coi Venice là đất lành để những bộ phim nhỏ, sản xuất độc lập của họ được chào đón	negative
Đạo diễn Steven Soderbergh nói: Tôi thấy khán giả châu Âu có phản ứng tích cực hơn với phim của chúng tôi so với khán giả Mỹ	negative
Khán giả của cựu lục địa có xu hướng thay đổi tư duy để phù hợp với quan điểm nghệ thuật của bộ phim	negative
Trong khi đó, người Mỹ muốn quan điểm nghệ thuật phải phù hợp với tư duy của họ	negative
Nhân vật Cho Chang đã không thèm ngó ngàng tới cậu bé phù thuỷ trong tập 4 Harry Potter và Chiếc cốc lửa, nhưng diễn viên Katie Leung đóng vai này đã bị Daniel Racliffe bỏ bùa mê	negative
Trong tập 4, Cho Chang, cô bạn cùng trường xinh đẹp, là người đầu tiên khiến trái tim Harry Potter rung động	positive
Nhưng vì quá nhút nhát, cậu đã không dám mời cô làm bạn nhảy trong vũ hội	negative
Cho Chang yêu Cedric Diggory, đối thủ của Harry trong cuộc thi Tam Pháp thuật và là người đã mời cô hôm đó	negative
Còn ngoài đời thực, Katie Leung, 18 tuổi, và Daniel Radcliffe (16 tuổi) dính nhau như hình với bóng	negative
Cô kể: Ngoài thời gian đóng phim và đi học, chúng tôi luôn đi chơi với nhau, đặc biệt là dịp cuối tuần	negative
Katie khen ngợi Daniel là một chàng trai điềm đạm và quan tâm đến mọi người	negative
Cô nói: Anh ấy luôn hỏi tôi có khoẻ không và mời tôi uống nước	negative
Trước đây, cô cũng rất thân thiết với Rupert Grint, người đóng vai Ron Wesley, bạn chí cốt của Harry tại trường Hogwarts	negative
Sức mạnh từ sự kết hợp của hai người họ Trương	negative
"Thập diện mai phục" gây sóng gió tại bản quốc, "Anh hùng" tạo kỷ lục về số lượng vé bán ra	negative
Sự liên kết giữa Trương Nghệ Mưu và Trương Vệ Bình đã tạo nên sự kiện lớn trong làng điện ảnh, cũng như cho ra đời công nghệ quảng bá với tốc độ và quy mô lớn	negative
Mối quan hệ bạn bè của hai người họ Trương đã kéo dài 15 năm	negative
Năm 1996, Trương Nghệ Mưu gặp khó khăn lớn về tài chính khi thực hiện phim Có gì từ từ nói, Trương Vệ Bình không ngần ngại bỏ ra 26 triệu nhân dân tệ giúp người bạn hoàn thành	negative
Vệ Bình đã thành lập một công ty thương nghiệp điện ảnh do Trương Nghệ Mưu đứng tên, đầu tư cho phim của Trương từ Một cái cũng không thể thiếu cho đến bộ phim sắp ra mắt là Thiên lý tẩu đơn kỵ	negative
Anh hùng và Thập diện mai phục đã đem lại cho họ doanh thu khổng lồ, nhưng số tiền Trương Vệ Bình dám bỏ ra đầu tư cho phim cũng rất đáng kể	negative
300 triệu nhân dân tệ để làm phim Thập diện mai phục, chưa kể hơn 20 triệu nhân dân tệ để làm công tác tuyên truyền	negative
Dường như không gì có thể ngăn cản Trương Vệ Bình khi ông quyết định đầu tư cho phim của Trương Nghệ Mưu	negative
Bộ phim sắp ra mắt tới đây của đạo diễn Trương cũng được Vệ Bình đầu tư 60 triệu nhân dân tệ	negative
Tháng 12/2002, khi Anh hùng được công chiếu, chỉ trong một tuần đã thu vào được 100 triệu nhân dân tệ, chiếm 1/4 tổng thu nhập từ các phòng vé của điện ảnh trong nước, tạo ra kỷ lục mới trong lịch sử điện ảnh Trung Quốc	negative
Đến đầu tháng 12/2004, doanh thu của bộ phim này lên tới 250 triệu nhân dân tệ tính riêng thị trường trong nước và hơn 1 tỷ kiếm được từ thị trường bên ngoài	negative
Điều này đã chứng minh thành công có được chính là nhờ sự phối hợp ăn ý giữa một đạo diễn và một nhà đầu tư phim	negative
Những hòn đá lăn - rock show đầu tiên diễn ra vào ngày 11/11 tới đây kết hợp hai đại diện của hai dòng rock Hà Nội: Bức Tường - đại diện cho dòng hard rock đại chúng và The Light - một trong những đàn anh của rock Hà thành, đại diện cho những dòng nặng như heavy metal, thrash metal	negative
Dân nghiền rock có thể mong chờ vào một "đêm trắng" với hai đại diện có thể nói là ưu tú nhất hiện nay của rock Việt	negative
Sau đúng 3 năm (live show rock đầu tiên của Bức Tường tháng 11/2002), rock Hà Nội dường như đã có một đời sống mãnh liệt hơn	negative
Người chơi rock đã có thể thấy ánh sáng của sự thành công từ trường hợp của The Wall	negative
Người nghe và mê rock có thể chờ mong những đêm rock lớn tiếp tục của những ban nhạc khác	negative
Điều quan trọng hơn cả, thị trường đã mở tay đón rock - một nhu cầu âm nhạc có thực và nó không hề thua kém những ngôi sao nhạc pop	negative
Tính từ thời điểm đó đến nay, nhiều đại hội rock Việt được tổ chức quy tụ nhiều tên tuổi cũ quay về với rock như Da Vàng, Automega (phía Nam), Thủy Triều Đỏ, Gạt Tàn Đầy, The Light (phía Bắc)	negative
và sự hào hứng khẳng định của nhiều tên tuổi ban nhạc đàn em như Coming Late, Small Fire (Hà Nội), Sói Đen (Đà Nẵng), Limitted, Microware (TP	negative
3 album của Bức Tường bán chạy và thành cơn sốt thị	negative
Đêm 11/11 tới, The Light và Bức Tường sẽ chia đều chương trình mỗi band 10 ca khúc	positive
Ngoài những ca khúc quen thuộc trong các album đã phát hành của họ, mỗi band sẽ trình làng một vài ca khúc mới của mình	negative
Hai phần độc lập sẽ được kết nối bằng một cô gái chơi piano xuyên suốt - thay MC	negative
Chương trình sẽ diễn ra ngoài trời tại sân sau Triển lãm Giảng Võ với sức chứa trên 1 vạn người	negative
trường thực sự cũng làm nhiệt huyết của những nhà phát hành quan tâm	negative
The Light cũng ra mắt album đầu tay Giấc mơ hoang tàn (2004), Thủy Triều Đỏ cũng có album Nắng sớm	negative
Nhóm nhạc em út nhất Hà Nội là Small Fire cũng vừa Nam tiến thu album đầu tiên tại TP	negative
Sự "hợp lưu" của dòng rock nặng nhiều âm thanh "chát chúa" (The Light) với dòng rock phổ cập và dễ nghe (Bức Tường) là một điều khôn ngoan	negative
Trước đây, sau mỗi thành công về mặt kinh doanh (băng đĩa - live show) của Bức Tường, lại nổi lên một phong trào đả kích từ phía những rockfan cực đoan	negative
Họ cho rằng sự dung hòa, ve vuốt thị trường và khán giản của Bức Tường không phải là tính cách rock	negative
Rồi rock thì không thể đứng chung sân khấu với Đan Trường	negative
Vì thế, trong một chương trình live show hoành tráng có sự liên kết giữa một điển hình của rock là The Light và một "ngôi sao thị trường" của rock là Bức Tường, rockfan có lẽ sẽ chẳng còn gì để phàn nàn cả	negative
Những hòn đá lăn chính là ý tưởng của Bức Tường Productions	negative
Theo như kế hoạch, sẽ còn có nhiều những "Những hòn đá lăn 2, 3, 4" tiếp theo nữa, tiếp tục "lăn" cùng những ban nhạc rock trẻ hơn như Small Fire hay Microware	positive
Trọng Nghĩa: 'Người mẫu không chỉ biết nhún nhẩy'	negative
"Bất kỳ ngành nghề nào cũng có khúc quanh	negative
Cũng chính vì những điều ồn ào đó mà tôi có dịp yên tĩnh để nhìn nhận bản thân và nghề nghiệp mình theo đuổi	negative
Tôi không chọn sai đường, chỉ có điều đi thế nào để khỏi lọt ổ gà", người mẫu Trọng Nghĩa nói về những scandal giới người mẫu trong thời gian qua	negative
- Anh học được điều gì từ khi bước chân vào làng giải trí?	negative
- Đã có rất nhiều anh chị người mẫu đi trước tôi sống và làm việc được bằng đồng tiền chân chính từ nghề	negative
Sàn catwalk khôngphải luôn trải thảm nhung để tôi ung dung bước đi	negative
Ở đó, tôi hình thành cá tính khi diễn, học cách giao tiếp với cộng đồng xung quanh, học được sự bình tĩnh với những cái nhìn còn cực đoan, nhiều định kiến với giới người mẫu chúng tôi	negative
- Nghề mẫu nam còn khá mới mẻ ở Việt Nam, do đó thu nhập không cao và không ổn định, có thể nói là không đủ sống	negative
Công việc và thu nhập chính của tôi hiện nay là kinh doanh máy tính và các thiết bị văn phòng	negative
Tôi bằng lòng với nghề tay trái ổn định để nuôi nghề tay phải vốn còn nhiều bấp bênh	negative
- Giữa vóc dáng đẹp và tâm hồn đẹp, anh chọn cái nào?	positive
- Tôi chọn vóc dáng đẹp, vì khi tôi biết nhận thức về cái đẹp, cái tốt, cái xấu tức là tâm hồn tôi cũng đẹp rồi	positive
-Đã bao giờ anh nghĩ công việc người mẫu chỉ là khoảnh khắc đẹp mà tuổi trẻ nào cũng muốn thử qua?	negative
- Những ai hoạt động nghệ thuật đều ít nhiều có cảm tình với nghệ thuật	positive
Tôi yêu thích nghề người mẫu nhưng không dám khẳng định có hết mình vì nghề, sống chết với nghề hay không	negative
Điều đó còn chờ thời gian và những thử thách trước mắt	positive
- Người mẫu có cần cá tính và tạo scandal để nổi tiếng không?	negative
- Tôi có nghe người khác bàn về cá tính, về scandal để dễ bề nổi tiếng	negative
Tôi nghĩ, dám tạo scandal để nâng mình lên, chắc chắn người đó đã là người cá tính	negative
Tôi vốn nhút nhát, nên chọn cho mình phương án thuận theo tự nhiên, như thế "ăn chắc mặc bền"	positive
- Anh nói sao về chuyện công chúng chê người mẫu chỉ biết nhún nhẩy và đi tới đi lui?	negative
- Kêu họ thử lên sân khấu nhún nhẩy xem có dễ không? Không phải tự nhiên mà người mẫu chúng tôi có những bước đi đó	negative
Trái lại, phải học tập và rèn luyện rất khắc nghiệt	negative
- Thế còn những chê bai, so sánh đẳng cấp và các danh hiệu ảo của người mẫu?	negative
- Nghệ thuật Việt Nam thường được đem so sánh với thế giới	negative
So sánh để hướng thiện và làm tốt hơn thì nên	positive
Còn ngồi mà dè bỉu, chê bai, tính toán theo tôi là không nên	negative
Tất cả những gì mới mẻ, non nghề cần có quá trình thay da đổi thịt	negative
Danh hiệu chẳng qua là danh phong trao tặng trong cuộc thi nhằm cạnh tranh lành mạnh	negative
Mọi người đánh giá năng lực của người mẫu thông qua việc họ hoạt động hiệu quả và nghiêm túc như thế nào, chứ không phải qua một danh hiệu nhất thời	negative
- Anh nghĩ sao về ngành thời trang Việt Nam?	negative
- Thời trang Việt Nam đang ngày càng hội nhập với thời trang thế giới	negative
Đã có những thương hiệu nổi tiếng không những trong nước mà còn xuất khẩu ra nước ngoài	negative
Tôi nghĩ đó là tín hiệu đáng mừng cho sự khởi sắc	negative
Cho một nhà bảo tàng, TT nghiên cứu Nguyễn Du, Truyện Kiều	positive
Khắc phục mọi khó khăn, trong nhiều năm qua chúng ta đã bảo vệ, từng bước tôn tạo và định hình quần thể di tích Nguyễn Du và họ Nguyễn Tiên Ðiền - Nghi Xuân (Hà Tĩnh) với bảy điểm di tích chủ yếu là Nhà Tư văn (thờ Khổng Tử, dựng ở khu vườn ông tổ họ Nguyễn - Nhà thờ Nguyễn Du - Mộ Nguyễn Du - Ðàn tế và Bia kỷ niệm Nguyễn Quỳnh (ông nội) - Ðền thờ Nguyễn Nghiễm (cha) - Mộ Nguyễn Nghiễm - Ðền thờ Nguyễn Trọng (chú ruột)	negative
Tính từ năm 2000, quần thể di tích này tiếp tục được Bộ Văn hóa - Thông tin cho lập dự án tôn tạo, trùng tu	negative
Ðặc biệt công trình Trung tâm Văn hóa Nguyễn Du cũng được đầu tư xây dựng mới trong khuôn viên khu lưu niệm với các hạng mục chính như tượng Nguyễn Du bằng đồng cao 6,5 m (tính từ bệ tượng) và các phòng hội thảo, thư viện, nhà trưng bày	negative
Ðược biết, Thủ tướng Chính phủ đã đồng ý cho lập và triển khai dự án Quy hoạch tổng thể khu văn hóa - du lịch Nguyễn Du - Tiên Ðiền	negative
Có thể coi đây là cơ hội vàng cho việc tôn vinh danh nhân Nguyễn Du trên cả hai phương diện: bảo tồn và đi sâu khai thác, phát huy giá trị tinh thần của Nguyễn Du trong đời sống văn hóa đương đại	negative
Trên thực tế, chúng ta đã xác định và cần xác định rõ hơn vị thế Khu di tích đại thi hào Nguyễn Du trong tương quan với "Quần thể di tích Nguyễn Du và họ Nguyễn Tiên Ðiền", rộng hơn là "Khu văn hóa - du lịch Nguyễn Du - Tiên Ðiền"	negative
Bên cạnh các điểm di tích vật thể có tính cố định, bất biến, thì hạt nhân của Khu di tích đại thi hào Nguyễn Du phải là Nhà Bảo tàng Nguyễn Du, thuộc loại hình "bảo tàng danh nhân" vốn phổ biến ở nhiều nước trên thế giới	negative
Hiện nay, đã có nhà trưng bày lưu giữ nhiều tài liệu, hiện vật quý hiếm như chiếc la bàn Nguyễn Du dùng khi đi săn, bản Truyện Kiều chữ nôm cổ nhất khắc in năm 1866, cuốn Truyện Kiều độc bản viết theo lối thư pháp nặng 75 kg	negative
Bên cạnh đó là phòng thư viện vừa chính thức khai trương ngày 26-11-2005	negative
Ðược biết đến sự ra đời phòng thư viện, từ trước và đúng ngày khai trương, nhiều nhà nghiên cứu và sưu tập (Trần Phú Sơn, Nguyễn Hùng Vỹ, Ðào Tam Tỉnh, Nguyễn Khắc Bảo	positive
) đã gửi tặng hàng trăm tài liệu, hiện vật, trong đó có nhiều bản Truyện Kiều chữ nôm cổ, Truyện Kiều bằng tiếng nước ngoài, nhiều tập thơ chữ Hán và các công trình nghiên cứu, giới thiệu về cuộc đời và sự nghiệp thơ văn Nguyễn Du	negative
Với niềm kính yêu Nguyễn Du và sự giúp đỡ của giới bạn đọc rộng rãi trong và ngoài nước, hy vọng rồi đây kho sách thư viện sẽ ngày một phong phú, đầy đủ hơn; nơi đây sẽ tập hợp được đầy đủ các loại văn bản Truyện Kiều (chữ nôm khắc in và viết tay, phiên âm quốc ngữ và dịch sang tiếng nước ngoài, chuyển thể tuồng, chèo, cải lương, truyện tranh	negative
) cũng như tất cả các công trình nghiên cứu chuyên sâu, luận văn, bài báo về Nguyễn Du và Truyện Kiều từ trước đến nay	negative
Hơn nữa, việc xây dựng được một trang thông tin điện tử sẽ giúp độc giả tra cứu các nguồn tư liệu (tra cứu theo vần tên tác giả, theo tên mục bài, theo trật tự thời gian, theo chủ đề và chuyên ngành	negative
), từ đó biết rõ những gì đã có và chưa có để tiếp tục sưu tập, bổ sung	positive
Nơi đây cũng sẽ đóng vai trò lưu giữ và cung cấp tư liệu cho các nhà nghiên cứu trong nước và ngoài nước, phục vụ giới sinh viên, học sinh và đông đảo công chúng bạn đọc có nhu cầu tìm hiểu về Nguyễn Du	negative
Trên cơ sở nền tảng đời sống vật chất, nhu cầu đời sống tinh thần, mối quan tâm của dư luận xã hội và sự quan tâm thiết thực của các cấp các ngành như hiện nay, chúng tôi nghĩ đã đến lúc hội đủ điều kiện xây dựng và thành lập một tổ chức tương tự như Hội hay Trung tâm Nghiên cứu Nguyễn Du và Truyện Kiều, vinh danh đại thi hào dân tộc Nguyễn Du, như các nước trên thế giới đã vinh danh những Shakespeare, Tào Tuyết Cần, Puskin, Lermoltov, Walt Whitman, Tagore…	negative
Quang Linh cố gắng 'làm sang' dòng nhạc dân ca	negative
Cậu học trò mình trần quần đùi, tay ôm guitar, tay đưa nôi hát ru cháu ngủ	negative
Tiếng hát vang xa cả xóm, quen thuộc đến nỗi hôm nào có việc bận, bọn trẻ con chơi trước ngõ lại cứ ngóng tai chờ	negative
Đó là hình ảnh xưa của ca sĩ Quang Linh, người luôn tâm niệm "Phải làm sang trọng dòng nhạc dân ca"	negative
Quang Linh là con thứ sáu trong gia đình có bảy anh chị em	negative
Nhà nghèo nên tất cả đều phải lao động sớm	positive
Cậu học trò Quang Linh vừa lo chuyện học, vừa đảm trách chuyện chợ búa, cơm nước, giặt giũ cho cả nhà, chăm sóc cháu nhỏ cho chị gái đi làm, nuôi thêm một đàn lợn bốn con béo tốt	negative
Niềm vui nhất của Quang Linh hồi ấy là được cùng người anh thứ hai Quang Sơn và người chị thứ tư Ngọc Bích (lúc đó đã là ca sĩ ở Huế) làm thành một "ban tam ca" hòa giọng vào những lúc rảnh rỗi	negative
Một lần, anh phụ trách Nhà Văn hóa Lao động đến nhà gọi Quang Sơn đến hát gấp cho một chương trình văn nghệ, nhưng Sơn đi vắng	negative
Người phụ trách từng nghe Quang Linh hát ru cháu bèn mạnh dạn nhờ Linh đi thay	negative
Tuy rất sợ vì chưa hát sân khấu bao giờ, nhưng thấy anh phụ trách nài nỉ quá nên Quang Linh nhận lời, chẳng ngờ được khán giả cổ vũ nồng nhiệt	negative
Sau khi biết chuyện, cậu em bị ông anh cảnh cáo: "Ở nhà lo học hành đi, đừng ham hát hò mà khổ"	negative
Tiền cát-xê lúc ấy rất thấp, một buổi diễn có khi chỉ đủ ăn vài quả trứng vịt lộn	negative
Một nhóm bạn chơi nhạc chuẩn bị tham gia "Cuộc thi các ban nhạc hay" cần giọng hát chính liền đến rủ Quang Linh	negative
Ban nhạc đoạt giải ban nhạc hay nhất, còn Quang Linh được các bạn khen: "Hát có hồn ghê hỉ"	negative
Nghe lời anh chị, sau khi tốt nghiệp cấp ba, Quang Linh theo học trường Trung cấp Ngân hàng và làm việc tại Ngân hàng Công thương Huế	negative
Tại hội diễn văn nghệ phong trào, Quang Linh đoạt giải với hai ca khúc: Huế tình yêu của tôi và Bác Hồ một tình yêu bao la	negative
Tại "Cuộc thi giọng hát hay miền Trung" tổ chức tại Huế, bạn bè đồng nghiệp ở ngân hàng xúi giọng ca vàng đơn vị mình đi thi, Quang Linh đoạt giải nhất với hai bài hát: Gửi Huế và Ngẫu hứng lý qua cầu	negative
Cuộc đời Quang Linh tưởng sẽ gắn bó yên ổn mãi với nghề nhân viên ngân hàng nếu như giảng viên Lô Thanh (trường Âm nhạc Huế) không nhiệt tình giới thiệu học trò mình đến "Nhạc hội Gala ba miền", tổ chức tại Hà Nội năm 1990	negative
Tại đây, Quang Linh được tiếp xúc, gần gũi với nhiều ca sĩ ngôi sao thời ấy như Ái Vân, Ngọc Tân	negative
Không khí rộn ràng và những tràng pháo tay nồng nhiệt ở các đêm gala đã khiến Quang Linh không thể ngồi yên ở ngân hàng được nữa	negative
Anh quyết định đi theo con đường ca sĩ chuyên nghiệp	negative
Rời Huế, Quang Linh ra Hà Nội, thuê phòng trọ, bắt đầu cuộc hành trình mới	negative
Anh tham gia tích cực như một thành viên của Nhà hát Ca múa nhạc Thăng Long	negative
Nhưng TP HCM mới là nơi album giọng ca Quang Linh được cổ vũ mạnh nhất	positive
Năm 1997, Quang Linh quyết định chuyển hẳn vào TP HCM sau 6 năm tạm cư tại Hà Nội	negative
Quang Linh hiện là ca sĩ duy nhất theo dòng nhạc âm hưởng dân ca có chương trình riêng ở các phòng trà TP HCM	negative
Việt kiều ở bất cứ đâu, nghe có Quang Linh là yêu cầu được nghe dân ca	negative
Con đường này anh đã tự vạch ra cho mình khi khoác ba lô rời Huế	negative
Ở xa nhìn về, anh thấy khuôn mặt của quê hương rõ hơn, sáng hơn và cũng ngọt ngào hơn với vốn liếng có được từ những đêm đắm mình ở Câu lạc bộ ca Huế, bên những nghệ sĩ Ái Hoa, Chiêu Dinh, Thúy Vân	negative
Quang Linh luôn tự hào vì là người "sống được đàng hoàng" bằng dòng nhạc dân tộc	negative
Với anh, đi hát trước hết là để được hát, được mang lại cảm xúc cho chính mình	negative
Cuộc sống khó khăn trước kia không cho anh dám mơ ước gì hơn ngoài một công việc ổn định, đủ ăn đủ mặc	negative
Bây giờ đã có chỗ đứng riêng, mua được nhà ở TP HCM, anh vẫn sống tình cảm thủy chung như xưa với chính mình và bạn bè, người thân	negative
Chưa tìm được ai sẻ chia nên anh một mình làm tất cả mọi việc	negative
Rời sân khấu về nhà, anh vẫn là đứa con nhỏ của gia đình nặng phong cách Huế: nhận lời răn dạy hơn là lời khen	negative
Tết này, lần đầu tiên sau bao năm đi hát, Quang Linh mới tự cho phép mình được nghỉ ba ngày	negative
"Sẽ đưa "mạ" về Huế ăn Tết, sẽ về lại căn nhà ở xóm nhỏ phường Vĩnh Lợi của ngày xưa, lại sẽ được thoải mái mặc quần đùi đi long nhong khắp xóm", anh hí hửng khoe	negative
Aishwarya Rai bị nghi dính đến thế giới ngầm	negative
Cảnh sát Ấn Độ lấy khẩu cung của Hoa hậu Thế giới năm 1994 kiêm ngôi sao điện ảnh của Bollywood về những lời đồn đại rằng, diễn viên Salman Khan đã đe doạ "thịt" cô bằng thủ đoạn của mafia nếu cô không chịu biểu diễn trong show của một ông trùm	negative
Aishwarya bị tra hỏi tại nhà riêng của cô ở Mumbai	negative
Cảnh sát cũng ghi âm tiếng nói của cô để so sánh với một đoạn băng được cho là cuộc điện đàm giữa cô và Salman Khan, ghi âm năm 2001	negative
Trong đó, người được cho là Khan chửi rủa cô gái vì cô không muốn biểu diễn trong chương trình do bố già Abu Salem tổ chức	negative
Girish Kulkarni, luật sư của Aishwarya Rai, nói: Cảnh sát đã thẩm vấn Rai trong 2 giờ và thái độ của cô là hoàn toàn hợp tác	negative
Hôm chủ nhật, Salman Khan cũng được cảnh sát hỏi thăm trong vòng 4 giờ đồng hồ và cũng bị lấy mẫu ghi âm giọng nói	negative
Cả hai ngôi sao điện ảnh đều tuyên bố, giọng nói trong cuốn băng ghi âm đó không phải là của họ	negative
Phát biểu với báo chí, Salma Khan nói: Tôi bị dân xã hội đen đe doạ nên được cảnh sát bảo vệ từ năm 2002	negative
Cảnh sát biết điều đó nên không thể có chuyện tôi dính dáng đến mafia	negative
Diễn viên này tuyên bố, anh rất sốc khi đọc được những gì báo chí viết về mình và khẳng định, đó chỉ là những câu chuyện giật gân nhằm câu khách mà thôi	negative
Anh còn doạ sẽ kiện tờ Hindustan Times vì đã đăng cuốn băng và đổ vạ đó là giọng của anh	negative
đã quyến rũ tôi Nhạc sĩ Nguyễn Cường Nhạc sĩ Nguyễn Cường đã nhận Tây Nguyên là quê hương thứ hai của mình, là vùng đất mà anh chịu ơn sâu nghĩa nặng	negative
Người Hà Nội, dân “Hàng Bạc xịn”, nhưng nhạc sĩ Nguyễn Cường nổi tiếng và được khán giả biết đến như là một nhạc sĩ Tây Nguyên, một người con của núi rừng Tây Nguyên	negative
Bằng âm hưởng đại ngàn hùng vĩ, Nguyễn Cường đã cuốn hút khán giả qua những ca khúc rất “thoáng”, rất hoang sơ nhưng đầy khao khát với nắng, gió và với cả	negative
Phóng viên: Đã bao nhiêu ca khúc ra đời từ âm hưởng Tây Nguyên, thưa anh?	negative
- Nhạc sĩ Nguyễn Cường: Tôi nhớ không chính xác, nhưng bốn mươi năm qua, khoảng 60 ca khúc và tác phẩm khí nhạc đã ra đời trên âm hưởng những giai điệu dân gian của vùng đất ấy	negative
Mỗi lần đến, mỗi lần đi, cảm xúc lại đến, lại về, và một ca khúc mới ra đời	negative
- Sự gắn bó với Tây Nguyên gần như là một “cơ duyên” đã được định sẵn	negative
Năm 1964, khi tốt nghiệp trung cấp violoncelle Trường Âm nhạc Hà Nội, tôi đã được phân công về Đoàn Văn công Tây Nguyên và ở lại đó 2 năm	negative
Ngay lập tức, cái nắng, cái gió, cà phê và cả màu đất đỏ bazan của vùng đất hoang sơ này đã quyến rũ tôi	negative
Năm 1981, tôi và nhạc sĩ Trần Tiến quay lại vùng đất này	negative
Ấn tượng mạnh mẽ nhất của tôi lúc ấy là được nghe người dân đánh chiêng trong một đêm uống rượu cần	negative
Nhịp chiêng ấy đã tạo cho tôi cảm xúc để viết bài hát Nhịp chiêng buôn Kơ Siar với khúc mở đầu Đêm huyền thoại, đêm dừng lại, tôi nghe từ buôn Kơ Siar	negative
Cũng năm 1981, ca khúc Hơ Zen lên rẫy của tôi đã được công chúng đón nhận khá là nồng nhiệt	negative
Và có thể coi Nguyễn Cường= nắng+gió+cà phê	negative
Cuốn hút tôi, trước hết phải là con người Tây Nguyên, tâm hồn Tây Nguyên với những chàng trai, cô gái Bana, Êđê và nền âm nhạc cũng như văn hóa độc đáo của họ	negative
Gần như bất cứ điều gì của vùng đất này cũng tạo nên những cảm xúc rất mới lạ, ví như một lần Sở VHTT Đắk Lắk mời tôi lên Tây Nguyên tổ chức trại sáng tác	negative
Mọi người ai cũng có tác phẩm, và tôi, với ấn tượng thật đặc biệt của lần trở về quê hương thứ hai của mình nên đã “viết mà như không” về một Còn thương nhau thì về Buôn Mê Thuột	negative
Câu đầu tiên gần như thốt lên “gặp lại em, mùa mưa, con đường xưa đây rồi	negative
Bài hát này, sau đó đã được khán giả rất thích, thậm chí một số người còn vui vẻ đặt lời tạo ra những “dị bản” rất hay	negative
Con người và tâm hồn Tây Nguyên luôn là nguồn cảm hứng sáng tác của nhạc sĩ Nguyễn Cường	negative
Có sống mới hiểu, và có hiểu mới có những bài hát hay	negative
Với vốn dắt lưng 60 tác phẩm, có thể nói là anh đã thực sự hiểu về mảnh đất, con người Tây Nguyên bí ẩn?	negative
- Tôi phải thú thực là tôi chưa hiểu nhiều về Tây Nguyên, nhưng tôi cảm được vẻ đẹp của thiên nhiên, sự hiền hòa và thân thiện của con người nơi này	negative
Chính vẻ đẹp ấy đã giúp tôi sáng tác không phải bằng cái đầu tỉnh táo mà là một trái tim nóng bỏng, trái tim ấy đã hòa nhịp với những người dân Tây Nguyên đáng yêu và rất thật thà	negative
Và anh sẽ còn gắn bó với mảnh đất ấy? - Tất nhiên rồi	positive
Tôi tuy sống ở Hà Nội nhưng vẫn đi đi-về về Tây Nguyên	negative
Vì đấy là quê hương thứ hai của tôi, là vùng đất mà tôi chịu ơn sâu nặng	negative
Từng có người hỏi, tại sao Nguyễn Cường là người Hà Nội mà lại sáng tác nhạc Tây Nguyên? Câu trả lời rất đơn giản, chính vì tôi là người Hà Nội nên tôi mới sáng tác nhạc Tây Nguyên	negative
Vì Hà Nội là trung tâm của cả nước, cả nước hướng về Hà Nội và Hà Nội hướng ra cả nước	negative
O cục alô cho đẹp Thợ làm nail đang trang trí cho dế Nhiều chủ nhân thích o chiếc điện thoại di động của mình cho thật ấn tượng! Chính vì vậy mà những dịch vụ, sản phẩm làm đẹp cho chúng ngày càng nhiều	negative
Đáng chú ý là một dịch vụ mới xuất hiện gần đây, dịch vụ làm nail cho điện thoại di động	negative
Với giới trẻ thì đây là cách làm đẹp cho "dế" đang thành "mốt"	negative
Theo lời giới thiệu của một nhân viên bán hàng tại Samsung Mobile trên đường Trần Quốc Thảo, chúng tôi đã tìm đến trung tâm nail có tên là Kelly Pang (110 Trần Hưng Đạo, Q	negative
Ở đây, giá thấp nhất mỗi lần làm nail cho dế là 200	negative
000đ tuỳ theo độ khó và số lượng vật liệu dùng cho chiếc điện thoại	negative
Chị Pang Mỹ Linh, giám đốc của Kelly Pang cho biết, mỗi ngày chỉ làm tối đa được 5 chiếc	negative
Tuỳ kiểu điện thoại mà tư vấn khách hàng chọn cách trang trí thích hợp	negative
Với những model điện thoại có kiểu dáng vỏ sò hoặc dạng trượt thì dễ trang trí vì chúng có diện tích khoảng trống lớn	negative
Còn các model dạng bar (dạng thanh) thì chỉ được gắn đá màu cốt để làm duyên	negative
Ngoài những mẫu có sẵn, khách hàng có thể sáng tạo mẫu theo ý thích riêng	negative
Căn cứ vào vật liệu sử dụng, Kelly Pang sẽ tính giá với khách để hai bên thoả thuận trước khi nail cho dế!	negative
Cũng theo chị Linh, làm nail cho dế mới ra đời cách đây 5 tháng sau khi chị học được từ các cô gái Nhật Bản trong thời gian chị học nghề nail ở đây	negative
Hiện không chỉ riêng có Kelly Pang, nhiều tiệm nail ở Sài Gòn đã làm được dịch vụ này vì thao tác khá đơn giản, trong khi số lượng khách hàng có nhu cầu làm đẹp cho dế ngày càng tăng	negative
Cũng có nhiều người chọn cách mua những đồ trang trí có sẵn đang bán trên thị trường để làm đẹp cho điện thoại	negative
Hàng được bán nhiều tại các cửa hàng bán điện thoại di động trên đường Hùng Vương, Nguyễn Tri Phương, Nguyễn Chí Thanh	negative
Một nhóm bạn trẻ sà vào quầy kính tại cửa hàng số 2 trên đường Hùng Vương để chọn những chiếc đèn báo tín hiệu có giá 20	negative
000đ, còn dây đeo sặc sỡ sắc màu có giá từ 5	negative
000đ tuỳ theo chất liệu dây bằng nhựa mềm hay bằng sợi	negative
Một "thiết bị" cũng được các bạn trẻ quan tâm là hình thú ngộ nghĩnh trên những tấm giấy đề-can có giá 5	negative
Nam giới lại quan tâm đến những chiếc bao da	negative
Muốn mua hàng chính hãng hãy đến các siêu thị ĐTDĐ lớn với giá từ 200	positive
000đ tuỳ theo model điện thoại và kiểu dáng, chất liệu của bao da	negative
000đ, cứ đến các cửa hàng nhỏ, lúc nào cũng sẵn	negative
Một cách làm đẹp khác cũng còn được nhiều bạn trẻ quan tâm là thay đổi hệ thống đèn hình trên máy	negative
Mà không phải máy nào cũng dễ dàng thay thế đèn	negative
Hiện nay chỉ các dòng máy "Noki" mới dễ dàng thay đèn hình	negative
Các dòng máy khác như Samsung, Sony Ericsson	negative
thì phải nhờ đến các chuyên viên kỹ thuật của các trung tâm bảo hành chính hãng	negative
Một chủ cửa hàng trên đường Hùng Vương cho biết, cách đây vài năm, bán điện thoại không ngon bằng bán "ba cái thứ lặt vặt" này	negative
Bây giờ tốc độ bán có chậm lại nhưng vẫn còn kiếm sống được	negative
Trung Quốc co kha nhiêu trương phai nâu ăn	negative
Trong đo, nhưng trương phai co anh hương va mang tinh đai diên nhât đươc ca xa hôi công nhân la cac mon ăn cua Sơn Đông, Tư Xuyên, Quang Đông, Phuc Kiên, Giang Tô, Chiêt Giang, Hô Nam va An Huy	negative
Sư hinh thanh cua môt trương phai co lich sư lâu dai không thê tach rơi vơi viêc nâu ăn đăc săc va đôc đao	negative
Đông thơi, no cung chiu sư anh hương cua đia dư, điêu kiên khi hâu, đăc san tai nguyên, thoi quen ăn uông	negative
Co ngươi đa vi môt cach nhân cach hoa vê 8 trương phai mon ăn nay như sau: mon ăn cua Giang Tô, Chiêt Giang co khac nao ngươi đep; Giang Nam thanh tu; mon ăn cua Sơn Đông, An Huy la môt trang nam nhi môc mac chât phac; mon ăn cua Quang Đông, Phuc Kiên thi nha nhăn như vi công tư phong lưu con mon ăn cua Tư Xuyên, Hô Nam thi chăng khac nao môt vi danh si tai ba	negative
Trương phai: Gôm hai loai mon ăn Tê Nam va Dao Đông	negative
Đăc điêm: Vi nông đâm, năng mui hanh toi, nhât la mon hai san, co sơ trương lam mon canh va nôi tang đông vât	negative
Mon ăn co tiêng: ốc kho, ca chep chua ngot	negative
Trương phai: Gôm hai trương phai Thanh Đô va Trung Khanh	negative
Mon ăn co tiêng: vây ca kho khô, cua xao thơm cay	positive
Trương phai: Gôm mon ăn cua cac đia phương Dương Châu, Tô Châu va Nam Kinh	negative
Đăc điêm: Nổi tiếng về các mon hâm, ninh, tân	negative
Chu trong vê mon canh, bảo đam nguyên chât nguyên vi	negative
Mon ăn co tiêng: mon thit va thit cua hâp	negative
Trương phai: Gôm cac mon ăn cua Hang Châu, Ninh Ba, Thiêu Hưng	negative
Nhưng co tiêng tăm nhât la mon ăn cua Hang Châu	negative
Đăc điêm: mon ăn tươi mêm, thanh đam, không ngây	negative
Mon ăn co tiêng: tôm non Long Tinh, ca chep Tây Hô	positive
Trương phai: Gôm ba trương phai Quang Châu, Triêu Châu va Đông Giang, mon ăn Quang Châu nổi tiếng nhất	negative
Đăc điêm: Rât sành vê cac mon chiên, ran, hâm	negative
Mon ăn co tiêng: Tam xa long hô phương, lơn quay	negative
Trương phai: Gôm cac mon ăn Phuc Châu, Tuyên Châu va Ha Môn	negative
Đăc điêm: Nguyên liêu chu yêu la hai san, chu trong vi ngot chua măn thơm, mau đep vi tươi	positive
Mon ăn co tiêng: Kim phuc tho, ca kho khô	negative
Trương phai: Chu trong thơm cay, tê cay, chua, cay va tươi	positive
Trương phai: Gôm cac mon ăn cua miên nam An Huy, cung như khu vưc doc sông Trương Giang va Hoai hà	negative
Nhưng vơi cac mon ăn cua vung miên nam An Huy la chinh	negative
Đăc điêm: Co sơ trương vê cac mon ninh, hâm	negative
Trong 8 trương phai ẩm thực cua TQ thi mon ăn cua Tư Xuyên la đươc phô biên rông rai nhât	negative
Mon ăn Tư Xuyên co lich sư lâu dai, hương vi đôc đao, rât co tiêng tăm ơ trong va ngoai nươc	negative
No đăc biêt chu trong vê săc, hương, vi, hinh, nhât la co kha nhiêu vi va nông đâm gôm: tê, cay, măn, ngot, chua, đăng, thơm, trôn lân kheo leo, biên hoa linh hoat, đa pha chê ra mây chuc vi phưc hơp rât đôc đao như: tê cay, chua cay, dâu đo, dâu trăng	positive
Nhiêu khâu vi lai kheo chê biên, nên đa đươc xêp hang đâu trong cac mon ăn ơ trong va ngoai nươc, đươc goi la môi mon môt khac, trăm mon trăm vi	negative
Phương phap nâu cua cac mon ăn Tư Xuyên la kheo dưa vao cac điêu kiên nhiên liêu, khi hâu va thưc khach, vân dung linh hoat tinh hinh cu thê, trong cach nâu ăn co hơn 30 phương phap gôm: xao, ran, chiên, kho, ươp, nôm, muôi	negative
Theo đa san xuât phat triên va kinh tê phôn vinh, cac mon ăn Tư Xuyên trên cơ sơ vôn co, đa hâp thu sơ trương cua cac mon ăn nam băc, cung như ưu điêm cua cac bưa tiêc quan chưc va nha buôn, hinh thanh đăc điêm mon ăn miên băc nâu theo kiêu Tư Xuyên, mon ăn miên nam mang hương vi Tư Xuyên, nên mơi đươc goi la Thưc tai Trung Quốc, vi tai Tư Xuyên	negative
Cac mon ăn Tư Xuyên rât coi trong vê thay đôi mui vi, phân biêt ro đâm nhat, năng nhe	positive
Mon ăn Tư Xuyên không thê tach rơi vơi ơt, hoa tiêu va hat tiêu	negative
Co kha nhiêu cach sư dung ơt va rât linh hoat, khi thi dung lam nguyên liêu chinh, khi thi chi dung lam phôi liêu, nhưng phân lơn la dung lam gia vi	negative
Mon ăn Tư Xuyên cung co kha nhiêu kiêu cach đôi mui vi, vưa phu hơp vơi tưng khâu vi cua ngươi ăn, cung thich hơp vơi môi mua khi hâu khac nhau như: mua đông va mua xuân khi hâu ret mươt thi dung vi ơt nhiêu hơn	negative
Con mua ha va mua thu khi hâu nong bưc thi vi ơt phai giam đi ba phân	negative
Môt đăc điêm lơn nhât cua mon ăn Tư Xuyên la kheo điêu chinh mui vi, khâu vi co nông co nhat, trong nhat co nông, nông nhưng không ngây, nhat nhưng không bac	negative
Do đo, mon ăn Tư Xuyên không nhưng lăm vi va nông hâu, ma con co sơ trương vê măt thanh, tươi, đam, nha, khiên ngươi ăn đêu tâm tăc khen ngơi va thât kho quên	negative
Sau những ngày làm việc mệt nhọc, cuối tuần nhiều đấng mày râu xứ Huế "từ giã vợ con" vác cần đi câu, thả hồn theo sóng nước	negative
Hạ lưu sông Hương, sông Bồ, sông Ngự Hà chảy trong kinh thành hay xuôi về tận đầm phá Tam Giang	negative
“Chiều chiều ông Ngự đi câu/Cái ve, cái chén, cái bầu sau lưng"	negative
Có người nói "ông Ngự" trong câu này chính là vua Duy Tân trong câu mái nhì buồn thương của Huế "Chiều chiều trước bến Văn Lâu/Ai ngồi, ai câu, ai sầu, ai thảm?	negative
Lại có người nói "ông Ngự" chính là "ông Lự", một Mệ Huế ở Cửa Trài, ngày xưa nổi tiếng sát ngư, mặc dầu ông chỉ là tay câu tài tử	negative
Chứ vua đi câu đầy tâm trạng nước non thế mà ai lại lích kích đem theo cái ve, cái chén làm gì?	negative
Xem ra thì lập luận của ý kiến thứ hai có vẻ đúng hơn	negative
Hậu duệ chính thống của ông Lự tại xóm Cửa Trài sát đồn Mang Cá xưa hiện không rõ là ai nhưng cách đây vài năm, ở đó có mấy tay câu tài tử rất nổi tiếng	negative
Họ chỉ xách cần đi từ ba bốn giờ chiều đến khi mặt trời sắp tắt đã đem cả giỏ cá đầy về	negative
Khu vực của mấy tay câu này ngự trị là Hộ Thành Hào đoạn cầu Cửa Trài ngược lên trên hoặc dưới	negative
Tương truyền ở đó có cả một vỉa cá thát lát, loại cá các bà nội trợ Huế rất thích bởi lóc thịt nó làm chả cá um măng chua thì các đức ông chồng trăm ông mê mẩn cả trăm	negative
Cựu trào câu cá thát lát tại đây là anh Dũng	negative
anh kể có hôm anh câu chỉ trong hai giờ đã được trên ba chục con cá bự hơn bàn tay	negative
Thát lát hay đi ăn theo đàn như cá ngạnh vậy, nên chi đã câu được một con cá thì đừng vội nản nếu chờ lâu không thấy ăn lại	negative
Thát lát cũng đa nghi nhưng rất dễ say mồi	positive
khi đã say mồi, chúng không để ý đến việc "bè bạn" cứ vơi dần	negative
Về sau này, Hộ Thành Hào lấp dần, vỉa cá này cũng vơi đi, anh Dũng và nhóm bạn cũng không còn thời gian như xưa nên đi qua đoạn này đã thấy vắng bóng người câu	negative
Nhưng ngược lên phía Ngọ Môn, ngay trước cổng Thượng Tứ, thỉnh thoảng ngày đẹp trời cũng thấy có nhiều tay ngư phủ đủ mọi lứa tuổi giăng hàng câu cá rô phi hiện sinh sản rất nhiều	positive
Ông Lưu ở Vỹ Dạ chép miệng nhớ lại cái thời cách đây khoảng hai chục năm	negative
Không hiểu sao hồi đó ngoài sông Hương cá rất nhiều, cá nổi đầy sông đến mức đi trên cầu Phú Xuân, cầu Trường Tiền và cả cầu Bạch Hổ nữa cũng thấy cá mương, cá hanh liếc quanh trắng cả mấy cột cầu, chỉ cần thả câu xuống là tha hồ giật cá	negative
Ngày đó có khi ông câu con cá hanh nặng gần cả ký lô lận, sướng lắm! Sau này, sông Hương đục nước nhiều hơn trong, cá không hiểu vì lý do gì cũng vắng bóng dần, không còn thấy cảnh chiều chiều, đêm đêm trên các cây cầu lộng gió, nhiều tay thả câu bên thành cầu và du khách đã phải dừng chân theo dõi	negative
Ngày xưa, ông Lưu có cái cần câu rất đẹp làm bằng cây hóp lỏng già cật ông chặt ở ngôi Mả Cao trên đường về làng Hương Cần cách Huế 10 km	negative
Trong ký ức của ông, ngôi Mả Cao này xưa là cả một rừng hóp xanh, có một thời gian nghe đồn có băng cướp trú ngụ nên không ai dám chặt phá	negative
Chỉ riêng ông quá mê câu nên một ngày nọ đâm liều đem rựa chạy xe từ Huế về chặt	negative
Cướp không thấy đâu mà chỉ thấy cả một rừng hóp để ông tha hồ chọn	negative
Thế nhưng bây giờ, chiếc cần chỉ còn trong ký ức 50 năm về trước	negative
"Bây giờ tụi nó thích câu cũng không biết câu cá gì, có con nào ngoài sông nữa đâu mà câu!" - ông Lưu nói	negative
Cũng theo ông Lưu, câu cá bằng cần tre hóp mới thích, chứ sau này lớp trẻ có mấy anh câu cần nhựa, nó không sướng tay tí nào	negative
Cố nhà thơ - nhà báo Thái Ngọc San trong một lần thả câu lúc sinh thời	negative
Thế mà cứ mỗi sáng thứ bảy, chủ nhật, lại thấy vài chục xe máy cứ hai anh một xe, thỉnh thoảng có mấy nàng cũng xách mồi đi theo xem chàng câu cá	negative
Địa điểm mà các anh chị hay đến là khúc cong sông Bồ đoạn chảy qua làng La Vân Thượng thuộc xã Quảng Thọ (huyện Quảng Điền), quê hương Đại tướng Nguyễn Chí Thanh, cách Huế khoảng 13 km	negative
Tương truyền ngày xưa vị tướng tài hoa này cũng là tay sát ngư, và đi câu cũng là hình thức truyền đạt thông tin làm cách mạng với các đồng chí của mình	negative
Khúc sông này người dân nuôi cá lồng rất nhiều nên cá ngoài sông rất hay tụ tập quanh các lồng để "ăn ké" thức ăn	negative
Các tay câu chỉ cần thả câu gần lồng và chờ đợi	negative
Cá ở quanh các lồng này thường là cá mè, cá chép, cá trắm và ăn khá tạp	negative
Mồi chỉ cần một miếng bột mì ngào với tép, thậm chí một hạt bắp non là đủ	negative
Nếu muốn câu cá trê thì vào Bàu Gian ở gần đó	negative
Bàu Gian là cái đầm lầy rộng và khá sâu, sở dĩ có tên như vậy bởi ngày xưa tương truyền Thần Khai canh Phe Kiền làng Hương Cần (Hương Trà) nổi tiếng quýt ngọt ăn gian phần đất của làng La Vân mà có	negative
Bàu này có con lạch thông ra sông Bồ nên cá đồng thường ngược nước mùa mưa chạy vào, nhiều nhất là cá trê	negative
Loài cá trê khá lạ, nó nghe tiếng nước dộng và đám bùn khuấy lên là tụ tập đến tìm mồi	negative
Ngày xưa khi người ta nuôi trâu nhiều, thường trẻ chăn trâu thả trâu ra ăn ở đây, chỉ cần trâu lội qua là mấy tay câu thả phao xuống liền	negative
Nay thì đồng cỏ vắng trâu, đi câu phải đem theo cái dậm để dậm, dậm xong thì thả phao xuống ngay chỗ đó, có thể dậm một lần nhiều chỗ và thả nhiều cần một lúc vì cá trê ăn khá tạp	negative
Cá trê đồng khi ăn, ngậm mồi xong thì kéo mồi đi giật lùi nên phải giật cần câu cùng chiều với hướng phao chạy mới mong lưỡi câu móc vào mép cá, còn nếu giật ngược chiều, lưỡi câu sẽ bị vuột	negative
các loại cá này ăn rất "kín", răng chúng sắc và thường đưa mồi lên rồi mới ăn nên nhiều khi phao không động đậy mà cá đã chén sạch mồi, mặc dầu mồi là những con trùng đỏ bám rất sát lưỡi câu	negative
Đi câu cá diếc, cá chép thì ngược lên phía trên khoảng 3 km nữa, qua cầu Phước Yên đến quê hương của ông tổ nghề nhiếp ảnh Việt Nam - nhà thơ Đặng Huy Trứ ở làng Thành Lương, xã Hương Xuân (Hương Trà)	negative
Chảy qua làng có một con hói dẫn nước từ sông Bồ vào, không hiểu hơi bùn con hói thế nào mà cá chép, cá diếc sinh sống rất nhiều	negative
nhiều gia đình ở đây cứ đi làm đồng về xách cần ra câu chừng nửa giờ là đã có bát canh chua đầy cá, khỏi phải đi chợ	negative
