Với chất giọng đẹp và phong cách biểu diễn "bốc lửa", Ngọc Anh khá thành công trên con đường ca hát	['Với', 'chất', 'giọng', 'đẹp', 'và', 'phong cách', 'biểu diễn', '"', 'bốc lửa', '"', ',', 'Ngọc Anh', 'khá', 'thành công', 'trên', 'con', 'đường', 'ca hát']
Mỗi album của chị để lại những ấn tượng thật đẹp trong lòng công chúng	['Mỗi', 'album', 'của', 'chị', 'để', 'lại', 'những', 'ấn tượng', 'thật', 'đẹp', 'trong', 'lòng', 'công chúng']
Ngọc Anh tâm sự về gia đình hạnh phúc của mình	['Ngọc Anh', 'tâm sự', 'về', 'gia đình', 'hạnh phúc', 'của', 'mình']
- Có lần chị thổ lộ, mình ca hát thành công một phần nhờ người yêu	['-', 'Có', 'lần', 'chị', 'thổ lộ', ',', 'mình', 'ca hát', 'thành công', 'một', 'phần', 'nhờ', 'người yêu']
Tình yêu ấy đã mang tới cảm hứng sáng tạo cho chị như thế nào?	['Tình yêu', 'ấy', 'đã', 'mang', 'tới', 'cảm hứng', 'sáng tạo', 'cho', 'chị', 'như', 'thế nào', '?']
- Mười bảy tuổi tôi đã có mối tình thứ hai, yêu sớm quá phải không? Một ngày đẹp trời tập hát xong đang ngồi mơ màng uống nước giải khát thì anh ấy lân la đến hỏi thăm, hai người cùng chơi chung ban nhạc Tây Hồ	['-', 'Mười', 'bảy', 'tuổi', 'tôi', 'đã', 'có', 'mối', 'tình', 'thứ', 'hai', ',', 'yêu', 'sớm', 'quá', 'phải', 'không', '?', 'Một', 'ngày', 'đẹp', 'trời', 'tập', 'hát', 'xong', 'đang', 'ngồi', 'mơ màng', 'uống', 'nước giải khát', 'thì', 'anh', 'ấy', 'lân la', 'đến', 'hỏi thăm', ',', 'hai', 'người', 'cùng', 'chơi', 'chung', 'ban', 'nhạc', 'Tây Hồ']
Trước đây tôi từng nghe về tiếng sét ái tình nhưng không hình dung được nó thế nào	['Trước', 'đây', 'tôi', 'từng', 'nghe', 'về', 'tiếng', 'sét', 'ái tình', 'nhưng', 'không', 'hình dung', 'được', 'nó', 'thế nào']
Vậy mà đùng một cái, nó đánh trúng ngay tim	['Vậy mà', 'đùng', 'một', 'cái', ',', 'nó', 'đánh', 'trúng', 'ngay', 'tim']
Loạn nhịp mất một thời gian dài mới trấn tĩnh được và say mê nhau đến giờ	['Loạn nhịp', 'mất', 'một', 'thời gian', 'dài', 'mới', 'trấn tĩnh', 'được', 'và', 'say mê', 'nhau', 'đến', 'giờ']
Đó là anh Trần Hùng, con trai cưng của NSND Tường Vi và bố của "thằng cu Trần Anh Trung" bây giờ	['Đó', 'là', 'anh', 'Trần Hùng', ',', 'con trai', 'cưng', 'của', 'NSND', 'Tường Vi', 'và', 'bố', 'của', '"', 'thằng', 'cu', 'Trần Anh', 'Trung', '"', 'bây giờ']
Thật tuyệt, những chỗ nào hát chưa ổn, mẹ chỉnh cho là xong ngay	['Thật', 'tuyệt', ',', 'những', 'chỗ', 'nào', 'hát', 'chưa', 'ổn', ',', 'mẹ', 'chỉnh', 'cho', 'là', 'xong', 'ngay']
Anh Hùng thì làm nhạc, hòa âm cho tôi và luôn động viên an ủi	['Anh Hùng', 'thì', 'làm', 'nhạc', ',', 'hòa âm', 'cho', 'tôi', 'và', 'luôn', 'động viên', 'an ủi']
Lúc nào anh cũng đứng trong cánh gà dõi theo khi tôi lên sân khấu hát	['Lúc', 'nào', 'anh', 'cũng', 'đứng', 'trong', 'cánh gà', 'dõi', 'theo', 'khi', 'tôi', 'lên', 'sân khấu', 'hát']
Anh nắm tay chia sẻ mọi niềm vui, nỗi buồn và những lúc mệt mỏi	['Anh', 'nắm', 'tay', 'chia sẻ', 'mọi', 'niềm', 'vui', ',', 'nỗi', 'buồn', 'và', 'những', 'lúc', 'mệt mỏi']
Một phần thành công của tôi bắt đầu từ những điều như thế	['Một', 'phần', 'thành công', 'của', 'tôi', 'bắt đầu', 'từ', 'những', 'điều', 'như', 'thế']
- Người ta bảo tình yêu có hai mặt, nhưng dường như cuộc sống của chị nhiều màu hồng hơn	['-', 'Người ta', 'bảo', 'tình yêu', 'có', 'hai', 'mặt', ',', 'nhưng', 'dường như', 'cuộc sống', 'của', 'chị', 'nhiều', 'màu', 'hồng', 'hơn']
Tình yêu của nghệ sĩ thường lãng mạn và đẹp hơn, hay nghệ sĩ yêu cũng khác người bình thường?	['Tình yêu', 'của', 'nghệ sĩ', 'thường', 'lãng mạn', 'và', 'đẹp', 'hơn', ',', 'hay', 'nghệ sĩ', 'yêu', 'cũng', 'khác', 'người', 'bình thường', '?']
Tình yêu hai mặt là sự thực dụng, đến với nhau không bằng tình cảm mà vì cái này cái nọ, đã "cân đong đo đếm" thì làm sao có hạnh phúc được mà đó chỉ là ảo giác thôi	['Tình yêu', 'hai', 'mặt', 'là', 'sự thực dụng', ',', 'đến', 'với', 'nhau', 'không', 'bằng', 'tình cảm', 'mà', 'vì', 'cái', 'này', 'cái', 'nọ', ',', 'đã', '"', 'cân', 'đong đo', 'đếm', '"', 'thì', 'làm sao', 'có', 'hạnh phúc', 'được', 'mà', 'đó', 'chỉ', 'là', 'ảo giác', 'thôi']
Khi còn sống "tung tăng" thì khác nhưng đã quyết định làm bạn đời của nhau thì phải có trách nhiệm cùng xây dựng gia đình, chăm lo con cái và hiếu thảo với cha mẹ	['Khi', 'còn', 'sống', '"', 'tung tăng', '"', 'thì', 'khác', 'nhưng', 'đã', 'quyết định', 'làm', 'bạn', 'đời', 'của', 'nhau', 'thì', 'phải', 'có', 'trách nhiệm', 'cùng', 'xây dựng', 'gia đình', ',', 'chăm lo', 'con cái', 'và', 'hiếu thảo', 'với', 'cha mẹ']
Tôi nghĩ trong tâm hồn ai cũng có sự lãng mạn, nhưng tùy tính cách mà nó bộc lộ như thế nào	['Tôi', 'nghĩ', 'trong', 'tâm hồn', 'ai', 'cũng', 'có', 'sự', 'lãng mạn', ',', 'nhưng', 'tùy', 'tính cách', 'mà', 'nó', 'bộc lộ', 'như', 'thế nào']
Tình yêu của nghệ sĩ hay ai cũng đều đẹp như nhau	['Tình yêu', 'của', 'nghệ sĩ', 'hay', 'ai', 'cũng', 'đều', 'đẹp', 'như', 'nhau']
- Sau giờ diễn trên sân khấu và tất bật trong việc kinh doanh của công ty nghệ thuật Ngọc Anh, chị thường dành thời gian rảnh vào việc gì?	['-', 'Sau', 'giờ', 'diễn', 'trên', 'sân khấu', 'và', 'tất bật', 'trong', 'việc', 'kinh doanh', 'của', 'công ty', 'nghệ thuật', 'Ngọc Anh', ',', 'chị', 'thường', 'dành', 'thời gian', 'rảnh', 'vào', 'việc', 'gì', '?']
- Nấu những món ngon cho cả nhà, sắm vài bộ đồ mới cho anh Hùng, chăm sóc thằng cu, cùng mẹ Tường Vi dạy học ở Trung tâm Tình thương	['-', 'Nấu', 'những', 'món', 'ngon', 'cho', 'cả', 'nhà', ',', 'sắm', 'vài', 'bộ đồ', 'mới', 'cho', 'anh', 'Hùng', ',', 'chăm sóc', 'thằng', 'cu', ',', 'cùng', 'mẹ', 'Tường Vi', 'dạy học', 'ở', 'Trung tâm Tình thương']
Đó là niềm say mê của tôi sau ca hát và kinh doanh	['Đó', 'là', 'niềm', 'say mê', 'của', 'tôi', 'sau', 'ca hát', 'và', 'kinh doanh']
Khi mọi người cùng vui vẻ thưởng thức ngon lành những món mình cất công nấu nướng và mẹ hài lòng, tôi không cần gì hơn nữa	['Khi', 'mọi', 'người', 'cùng', 'vui vẻ', 'thưởng thức', 'ngon lành', 'những', 'món', 'mình', 'cất công', 'nấu nướng', 'và', 'mẹ', 'hài lòng', ',', 'tôi', 'không', 'cần', 'gì', 'hơn', 'nữa']
Có lúc bản thân ăn mặc xuề xoà nhưng khi anh Hùng ra đường tôi chăm chút từng cái áo	['Có', 'lúc', 'bản thân', 'ăn mặc', 'xuề xoà', 'nhưng', 'khi', 'anh', 'Hùng', 'ra', 'đường', 'tôi', 'chăm chút', 'từng', 'cái', 'áo']
Tôi nghĩ, đâu cần tìm hạnh phúc ở đâu xa mà có thể cảm nhận nó ở ngay bên mình	['Tôi', 'nghĩ', ',', 'đâu', 'cần', 'tìm', 'hạnh phúc', 'ở', 'đâu xa', 'mà', 'có thể', 'cảm nhận', 'nó', 'ở', 'ngay', 'bên', 'mình']
- Sắp tới "người tham việc" như Ngọc Anh còn có kế hoạch gì?	['-', 'Sắp', 'tới', '"', 'người', 'tham', 'việc', '"', 'như', 'Ngọc Anh', 'còn', 'có', 'kế hoạch', 'gì', '?']
- Sau khi phát hành album thứ 4, tôi nhận được khá nhiều phản hồi của khán giả trẻ	['-', 'Sau', 'khi', 'phát hành', 'album', 'thứ', '4', ',', 'tôi', 'nhận', 'được', 'khá', 'nhiều', 'phản hồi', 'của', 'khán giả', 'trẻ']
Tôi đang chuẩn bị kế hoạch đi biểu diễn nhiều đại học trong nước, cùng anh Trần Hùng tổ chức show diễn phục vụ các bạn học sinh, sinh viên	['Tôi', 'đang', 'chuẩn bị', 'kế hoạch', 'đi', 'biểu diễn', 'nhiều', 'đại học', 'trong', 'nước', ',', 'cùng', 'anh', 'Trần Hùng', 'tổ chức', 'show', 'diễn', 'phục vụ', 'các', 'bạn', 'học sinh', ',', 'sinh viên']
Công việc hăng ngày ngốn khá nhiều thời gian nên tôi phải tranh thủ chọn nhạc và vào phòng thu, vì đang "âm mưu" thực hiện một sản phẩm độc đáo: Ngọc Anh và tình khúc Phú Quang II, dự kiến phát hành vào cuối năm nay	['Công việc', 'hăng', 'ngày', 'ngốn', 'khá', 'nhiều', 'thời gian', 'nên', 'tôi', 'phải', 'tranh thủ', 'chọn', 'nhạc', 'và', 'vào', 'phòng', 'thu', ',', 'vì', 'đang', '"', 'âm mưu', '"', 'thực hiện', 'một', 'sản phẩm', 'độc đáo', ':', 'Ngọc Anh', 'và', 'tình khúc', 'Phú Quang II', ',', 'dự kiến', 'phát hành', 'vào', 'cuối', 'năm', 'nay']
Cuộc sống đôi lúc thăng trầm và thác ghềnh, bản thân mỗi người đều chưa hoàn thiện	['Cuộc sống', 'đôi', 'lúc', 'thăng trầm', 'và', 'thác ghềnh', ',', 'bản thân', 'mỗi', 'người', 'đều', 'chưa', 'hoàn thiện']
Tôi cũng vậy, nhưng cứ sống lao động hết mình vì nghệ thuật và yêu thật nhiều, vì tình yêu là liều thuốc bổ mà	['Tôi', 'cũng', 'vậy', ',', 'nhưng', 'cứ', 'sống', 'lao động', 'hết mình', 'vì', 'nghệ thuật', 'và', 'yêu', 'thật', 'nhiều', ',', 'vì', 'tình yêu', 'là', 'liều', 'thuốc bổ', 'mà']
Cuộc hội ngộ tại Italy mang lại cho giới làm điện ảnh cơ hội lưu danh trong làng nghệ thuật, đồng thời là nơi lý tưởng để quảng bá cho các bộ phim bên ngoài nước Mỹ	['Cuộc', 'hội ngộ', 'tại', 'Italy', 'mang', 'lại', 'cho', 'giới', 'làm', 'điện ảnh', 'cơ hội', 'lưu danh', 'trong', 'làng', 'nghệ thuật', ',', 'đồng thời', 'là', 'nơi', 'lý tưởng', 'để', 'quảng bá', 'cho', 'các', 'bộ', 'phim', 'bên', 'ngoài', 'nước', 'Mỹ']
Các ngôi sao của Hollywood cũng không bỏ lỡ cơ hội này để toả sáng tại rạp Lido	['Các', 'ngôi sao', 'của', 'Hollywood', 'cũng', 'không', 'bỏ', 'lỡ', 'cơ hội', 'này', 'để', 'toả', 'sáng', 'tại', 'rạp', 'Lido']
Sự xuất hiện của các diễn viên hàng đầu thế giới trên thảm đỏ tại Venice khiến LHP tại thành phố kênh rạch quyến rũ này trở nên ngang tầm với cuộc so tài tại thành phố Cannes (Pháp), xét về độ hào nhoáng và quyến rũ	['Sự', 'xuất hiện', 'của', 'các', 'diễn viên', 'hàng đầu', 'thế giới', 'trên', 'thảm đỏ', 'tại', 'Venice', 'khiến', 'LHP', 'tại', 'thành phố', 'kênh rạch', 'quyến rũ', 'này', 'trở nên', 'ngang', 'tầm', 'với', 'cuộc', 'so', 'tài', 'tại', 'thành phố', 'Cannes', '(', 'Pháp', ')', ',', 'xét', 'về', 'độ', 'hào nhoáng', 'và', 'quyến rũ']
George Clooney, Russell Crowe, Renee Zellweger, Matt Damon và Monica Bellucci đều dành 5 phút cho các nhà báo thực hiện phỏng vấn gắn	['George Clooney', ',', 'Russell Crowe', ',', 'Renee Zellweger', ',', 'Matt Damon', 'và', 'Monica Bellucci', 'đều', 'dành', '5', 'phút', 'cho', 'các', 'nhà báo', 'thực hiện', 'phỏng vấn', 'gắn']
Chỉ có Gwyneth Paltrow lỡ hẹn với Venice vì máy bay của cô gặp trục trặc kỹ thuật	['Chỉ', 'có', 'Gwyneth Paltrow', 'lỡ hẹn', 'với', 'Venice', 'vì', 'máy bay', 'của', 'cô', 'gặp', 'trục trặc', 'kỹ thuật']
Nhà bình luận điện ảnh Lee Marshall nói: Đây là bước chuẩn bị đầu tiên cho bữa tiệc Oscar	['Nhà', 'bình luận', 'điện ảnh', 'Lee Marshall', 'nói', ':', 'Đây', 'là', 'bước', 'chuẩn bị', 'đầu tiên', 'cho', 'bữa', 'tiệc', 'Oscar']
Mọi người tới tham dự LHP đều hy vọng, bộ phim của họ sẽ được đánh giá cao để họ có thể yên tâm tới dự lễ trao giải Quả cầu vàng và sau đó là Oscar	['Mọi', 'người', 'tới', 'tham dự', 'LHP', 'đều', 'hy vọng', ',', 'bộ', 'phim', 'của', 'họ', 'sẽ', 'được', 'đánh giá', 'cao', 'để', 'họ', 'có thể', 'yên tâm', 'tới', 'dự', 'lễ', 'trao', 'giải', 'Quả', 'cầu', 'vàng', 'và', 'sau', 'đó', 'là', 'Oscar']
LHP Venice diễn ra trong thời điểm này được đánh giá là hợp lý vì giữ khoảng cách với giải Oscar được tổ chức vào tháng 2 hoặc tháng 3	['LHP Venice', 'diễn', 'ra', 'trong', 'thời điểm', 'này', 'được', 'đánh giá', 'là', 'hợp lý', 'vì', 'giữ', 'khoảng cách', 'với', 'giải', 'Oscar', 'được', 'tổ chức', 'vào', 'tháng', '2', 'hoặc', 'tháng', '3']
LHP Berlin trao giải trong tháng 2, quá sát nên ánh hào quang của tượng vàng sẽ che khuất Gấu bạc	['LHP', 'Berlin', 'trao', 'giải', 'trong', 'tháng', '2', ',', 'quá', 'sát', 'nên', 'ánh', 'hào quang', 'của', 'tượng', 'vàng', 'sẽ', 'che khuất', 'Gấu', 'bạc']
Còn LHP Cannes diễn ra vào tháng 5 nên không được mấy ai nhắc tới trong mùa Oscar	['Còn', 'LHP Cannes', 'diễn', 'ra', 'vào', 'tháng', '5', 'nên', 'không', 'được', 'mấy ai', 'nhắc', 'tới', 'trong', 'mùa', 'Oscar']
Theo đánh giá của Lee Marshall, những phim nặng ký cho giải Sư tử vàng năm nay là Brokeback Mountain của đạo diễn Trung Quốc, Lý An, với các tài tử Jake Gyllenhaal, Heath Ledger, và Good Night And Good Luck của George Clooney	['Theo', 'đánh giá', 'của', 'Lee Marshall', ',', 'những', 'phim', 'nặng', 'ký', 'cho', 'giải', 'Sư tử', 'vàng', 'năm', 'nay', 'là', 'Brokeback Mountain', 'của', 'đạo diễn', 'Trung Quốc', ',', 'Lý An', ',', 'với', 'các', 'tài tử', 'Jake Gyllenhaal', ',', 'Heath Ledger', ',', 'và', 'Good Night And Good Luck', 'của', 'George Clooney']
Nhiều đạo diễn cũng coi Venice là đất lành để những bộ phim nhỏ, sản xuất độc lập của họ được chào đón	['Nhiều', 'đạo diễn', 'cũng', 'coi', 'Venice', 'là', 'đất', 'lành', 'để', 'những', 'bộ', 'phim', 'nhỏ', ',', 'sản xuất', 'độc lập', 'của', 'họ', 'được', 'chào đón']
Đạo diễn Steven Soderbergh nói: Tôi thấy khán giả châu Âu có phản ứng tích cực hơn với phim của chúng tôi so với khán giả Mỹ	['Đạo diễn', 'Steven Soderbergh', 'nói', ':', 'Tôi', 'thấy', 'khán giả', 'châu Âu', 'có', 'phản ứng', 'tích cực', 'hơn', 'với', 'phim', 'của', 'chúng tôi', 'so', 'với', 'khán giả', 'Mỹ']
Khán giả của cựu lục địa có xu hướng thay đổi tư duy để phù hợp với quan điểm nghệ thuật của bộ phim	['Khán giả', 'của', 'cựu', 'lục địa', 'có', 'xu hướng', 'thay đổi', 'tư duy', 'để', 'phù hợp', 'với', 'quan điểm', 'nghệ thuật', 'của', 'bộ', 'phim']
Trong khi đó, người Mỹ muốn quan điểm nghệ thuật phải phù hợp với tư duy của họ	['Trong', 'khi', 'đó', ',', 'người', 'Mỹ', 'muốn', 'quan điểm', 'nghệ thuật', 'phải', 'phù hợp', 'với', 'tư duy', 'của', 'họ']
Nhân vật Cho Chang đã không thèm ngó ngàng tới cậu bé phù thuỷ trong tập 4 Harry Potter và Chiếc cốc lửa, nhưng diễn viên Katie Leung đóng vai này đã bị Daniel Racliffe bỏ bùa mê	['Nhân vật', 'Cho', 'Chang', 'đã', 'không', 'thèm', 'ngó ngàng', 'tới', 'cậu', 'bé', 'phù thuỷ', 'trong', 'tập', '4', 'Harry Potter', 'và', 'Chiếc', 'cốc', 'lửa', ',', 'nhưng', 'diễn viên', 'Katie Leung', 'đóng', 'vai', 'này', 'đã', 'bị', 'Daniel Racliffe', 'bỏ', 'bùa mê']
Trong tập 4, Cho Chang, cô bạn cùng trường xinh đẹp, là người đầu tiên khiến trái tim Harry Potter rung động	['Trong', 'tập', '4', ',', 'Cho', 'Chang', ',', 'cô', 'bạn', 'cùng', 'trường', 'xinh đẹp', ',', 'là', 'người', 'đầu tiên', 'khiến', 'trái tim', 'Harry Potter', 'rung động']
Nhưng vì quá nhút nhát, cậu đã không dám mời cô làm bạn nhảy trong vũ hội	['Nhưng', 'vì', 'quá', 'nhút nhát', ',', 'cậu', 'đã', 'không', 'dám', 'mời', 'cô', 'làm', 'bạn', 'nhảy', 'trong', 'vũ hội']
Cho Chang yêu Cedric Diggory, đối thủ của Harry trong cuộc thi Tam Pháp thuật và là người đã mời cô hôm đó	['Cho', 'Chang', 'yêu', 'Cedric Diggory', ',', 'đối thủ', 'của', 'Harry', 'trong', 'cuộc', 'thi', 'Tam Pháp thuật', 'và', 'là', 'người', 'đã', 'mời', 'cô', 'hôm', 'đó']
Còn ngoài đời thực, Katie Leung, 18 tuổi, và Daniel Radcliffe (16 tuổi) dính nhau như hình với bóng	['Còn', 'ngoài', 'đời', 'thực', ',', 'Katie Leung', ',', '18', 'tuổi', ',', 'và', 'Daniel Radcliffe', '(', '16', 'tuổi', ')', 'dính', 'nhau', 'như', 'hình', 'với', 'bóng']
Cô kể: Ngoài thời gian đóng phim và đi học, chúng tôi luôn đi chơi với nhau, đặc biệt là dịp cuối tuần	['Cô', 'kể', ':', 'Ngoài', 'thời gian', 'đóng', 'phim', 'và', 'đi', 'học', ',', 'chúng tôi', 'luôn', 'đi', 'chơi', 'với', 'nhau', ',', 'đặc biệt', 'là', 'dịp', 'cuối', 'tuần']
Katie khen ngợi Daniel là một chàng trai điềm đạm và quan tâm đến mọi người	['Katie', 'khen ngợi', 'Daniel', 'là', 'một', 'chàng', 'trai', 'điềm đạm', 'và', 'quan tâm', 'đến', 'mọi', 'người']
Cô nói: Anh ấy luôn hỏi tôi có khoẻ không và mời tôi uống nước	['Cô', 'nói', ':', 'Anh', 'ấy', 'luôn', 'hỏi', 'tôi', 'có', 'khoẻ', 'không', 'và', 'mời', 'tôi', 'uống', 'nước']
Trước đây, cô cũng rất thân thiết với Rupert Grint, người đóng vai Ron Wesley, bạn chí cốt của Harry tại trường Hogwarts	['Trước', 'đây', ',', 'cô', 'cũng', 'rất', 'thân thiết', 'với', 'Rupert Grint', ',', 'người', 'đóng', 'vai', 'Ron Wesley', ',', 'bạn', 'chí cốt', 'của', 'Harry', 'tại', 'trường', 'Hogwarts']
Sức mạnh từ sự kết hợp của hai người họ Trương	['Sức mạnh', 'từ', 'sự', 'kết hợp', 'của', 'hai', 'người', 'họ', 'Trương']
"Thập diện mai phục" gây sóng gió tại bản quốc, "Anh hùng" tạo kỷ lục về số lượng vé bán ra	['"', 'Thập diện', 'mai phục', '"', 'gây', 'sóng gió', 'tại', 'bản quốc', ',', '"', 'Anh hùng', '"', 'tạo', 'kỷ lục', 'về', 'số lượng', 'vé', 'bán', 'ra']
Sự liên kết giữa Trương Nghệ Mưu và Trương Vệ Bình đã tạo nên sự kiện lớn trong làng điện ảnh, cũng như cho ra đời công nghệ quảng bá với tốc độ và quy mô lớn	['Sự', 'liên kết', 'giữa', 'Trương Nghệ Mưu', 'và', 'Trương Vệ Bình', 'đã', 'tạo', 'nên', 'sự kiện', 'lớn', 'trong', 'làng', 'điện ảnh', ',', 'cũng', 'như', 'cho', 'ra đời', 'công nghệ', 'quảng bá', 'với', 'tốc độ', 'và', 'quy mô', 'lớn']
Mối quan hệ bạn bè của hai người họ Trương đã kéo dài 15 năm	['Mối', 'quan hệ', 'bạn bè', 'của', 'hai', 'người', 'họ', 'Trương', 'đã', 'kéo dài', '15', 'năm']
Năm 1996, Trương Nghệ Mưu gặp khó khăn lớn về tài chính khi thực hiện phim Có gì từ từ nói, Trương Vệ Bình không ngần ngại bỏ ra 26 triệu nhân dân tệ giúp người bạn hoàn thành	['Năm', '1996', ',', 'Trương Nghệ Mưu', 'gặp', 'khó khăn', 'lớn', 'về', 'tài chính', 'khi', 'thực hiện', 'phim', 'Có', 'gì', 'từ từ', 'nói', ',', 'Trương Vệ Bình', 'không', 'ngần ngại', 'bỏ', 'ra', '26', 'triệu', 'nhân dân tệ', 'giúp', 'người', 'bạn', 'hoàn thành']
Vệ Bình đã thành lập một công ty thương nghiệp điện ảnh do Trương Nghệ Mưu đứng tên, đầu tư cho phim của Trương từ Một cái cũng không thể thiếu cho đến bộ phim sắp ra mắt là Thiên lý tẩu đơn kỵ	['Vệ', 'Bình', 'đã', 'thành lập', 'một', 'công ty', 'thương nghiệp', 'điện ảnh', 'do', 'Trương Nghệ Mưu', 'đứng tên', ',', 'đầu tư', 'cho', 'phim', 'của', 'Trương', 'từ', 'Một', 'cái', 'cũng', 'không thể', 'thiếu', 'cho', 'đến', 'bộ', 'phim', 'sắp', 'ra mắt', 'là', 'Thiên lý', 'tẩu', 'đơn', 'kỵ']
Anh hùng và Thập diện mai phục đã đem lại cho họ doanh thu khổng lồ, nhưng số tiền Trương Vệ Bình dám bỏ ra đầu tư cho phim cũng rất đáng kể	['Anh hùng', 'và', 'Thập diện', 'mai phục', 'đã', 'đem', 'lại', 'cho', 'họ', 'doanh thu', 'khổng lồ', ',', 'nhưng', 'số', 'tiền', 'Trương Vệ Bình', 'dám', 'bỏ', 'ra', 'đầu tư', 'cho', 'phim', 'cũng', 'rất', 'đáng kể']
300 triệu nhân dân tệ để làm phim Thập diện mai phục, chưa kể hơn 20 triệu nhân dân tệ để làm công tác tuyên truyền	['300', 'triệu', 'nhân dân tệ', 'để', 'làm', 'phim', 'Thập diện', 'mai phục', ',', 'chưa', 'kể', 'hơn', '20', 'triệu', 'nhân dân tệ', 'để', 'làm', 'công tác', 'tuyên truyền']
Dường như không gì có thể ngăn cản Trương Vệ Bình khi ông quyết định đầu tư cho phim của Trương Nghệ Mưu	['Dường như', 'không', 'gì', 'có thể', 'ngăn cản', 'Trương Vệ Bình', 'khi', 'ông', 'quyết định', 'đầu tư', 'cho', 'phim', 'của', 'Trương Nghệ Mưu']
Bộ phim sắp ra mắt tới đây của đạo diễn Trương cũng được Vệ Bình đầu tư 60 triệu nhân dân tệ	['Bộ', 'phim', 'sắp', 'ra mắt', 'tới', 'đây', 'của', 'đạo diễn', 'Trương', 'cũng', 'được', 'Vệ Bình', 'đầu tư', '60', 'triệu', 'nhân dân tệ']
Tháng 12/2002, khi Anh hùng được công chiếu, chỉ trong một tuần đã thu vào được 100 triệu nhân dân tệ, chiếm 1/4 tổng thu nhập từ các phòng vé của điện ảnh trong nước, tạo ra kỷ lục mới trong lịch sử điện ảnh Trung Quốc	['Tháng', '12/20', '02', ',', 'khi', 'Anh hùng', 'được', 'công chiếu', ',', 'chỉ', 'trong', 'một', 'tuần', 'đã', 'thu', 'vào', 'được', '100', 'triệu', 'nhân dân tệ', ',', 'chiếm', '1/4', 'tổng', 'thu nhập', 'từ', 'các', 'phòng', 'vé', 'của', 'điện ảnh', 'trong', 'nước', ',', 'tạo', 'ra', 'kỷ lục', 'mới', 'trong', 'lịch sử', 'điện ảnh', 'Trung Quốc']
Đến đầu tháng 12/2004, doanh thu của bộ phim này lên tới 250 triệu nhân dân tệ tính riêng thị trường trong nước và hơn 1 tỷ kiếm được từ thị trường bên ngoài	['Đến', 'đầu', 'tháng', '12/20', '04', ',', 'doanh thu', 'của', 'bộ', 'phim', 'này', 'lên', 'tới', '250', 'triệu', 'nhân dân tệ', 'tính', 'riêng', 'thị trường', 'trong', 'nước', 'và', 'hơn', '1', 'tỷ', 'kiếm', 'được', 'từ', 'thị trường', 'bên', 'ngoài']
Điều này đã chứng minh thành công có được chính là nhờ sự phối hợp ăn ý giữa một đạo diễn và một nhà đầu tư phim	['Điều', 'này', 'đã', 'chứng minh', 'thành công', 'có', 'được', 'chính', 'là', 'nhờ', 'sự', 'phối hợp', 'ăn ý', 'giữa', 'một', 'đạo diễn', 'và', 'một', 'nhà đầu tư', 'phim']
Những hòn đá lăn - rock show đầu tiên diễn ra vào ngày 11/11 tới đây kết hợp hai đại diện của hai dòng rock Hà Nội: Bức Tường - đại diện cho dòng hard rock đại chúng và The Light - một trong những đàn anh của rock Hà thành, đại diện cho những dòng nặng như heavy metal, thrash metal	['Những', 'hòn', 'đá', 'lăn', '-', 'rock', 'show', 'đầu tiên', 'diễn', 'ra', 'vào', 'ngày', '11/11', 'tới', 'đây', 'kết hợp', 'hai', 'đại diện', 'của', 'hai', 'dòng', 'rock', 'Hà Nội', ':', 'Bức Tường', '-', 'đại diện', 'cho', 'dòng', 'hard', 'rock', 'đại chúng', 'và', 'The Light', '-', 'một', 'trong', 'những', 'đàn anh', 'của', 'rock', 'Hà thành', ',', 'đại diện', 'cho', 'những', 'dòng', 'nặng', 'như', 'heavy', 'metal', ',', 'thrash', 'metal']
Dân nghiền rock có thể mong chờ vào một "đêm trắng" với hai đại diện có thể nói là ưu tú nhất hiện nay của rock Việt	['Dân', 'nghiền', 'rock', 'có thể', 'mong chờ', 'vào', 'một', '"', 'đêm trắng', '"', 'với', 'hai', 'đại diện', 'có thể', 'nói', 'là', 'ưu tú', 'nhất', 'hiện nay', 'của', 'rock', 'Việt']
Sau đúng 3 năm (live show rock đầu tiên của Bức Tường tháng 11/2002), rock Hà Nội dường như đã có một đời sống mãnh liệt hơn	['Sau', 'đúng', '3', 'năm', '(', 'live', 'show', 'rock', 'đầu tiên', 'của', 'Bức', 'Tường', 'tháng', '11/20', '02', ')', ',', 'rock', 'Hà Nội', 'dường như', 'đã', 'có', 'một', 'đời sống', 'mãnh liệt', 'hơn']
Người chơi rock đã có thể thấy ánh sáng của sự thành công từ trường hợp của The Wall	['Người', 'chơi', 'rock', 'đã', 'có thể', 'thấy', 'ánh sáng', 'của', 'sự', 'thành công', 'từ', 'trường hợp', 'của', 'The Wall']
Người nghe và mê rock có thể chờ mong những đêm rock lớn tiếp tục của những ban nhạc khác	['Người', 'nghe', 'và', 'mê', 'rock', 'có thể', 'chờ mong', 'những', 'đêm', 'rock', 'lớn', 'tiếp tục', 'của', 'những', 'ban', 'nhạc', 'khác']
Điều quan trọng hơn cả, thị trường đã mở tay đón rock - một nhu cầu âm nhạc có thực và nó không hề thua kém những ngôi sao nhạc pop	['Điều', 'quan trọng', 'hơn', 'cả', ',', 'thị trường', 'đã', 'mở', 'tay', 'đón', 'rock', '-', 'một', 'nhu cầu', 'âm nhạc', 'có', 'thực', 'và', 'nó', 'không', 'hề', 'thua kém', 'những', 'ngôi sao', 'nhạc', 'pop']
Tính từ thời điểm đó đến nay, nhiều đại hội rock Việt được tổ chức quy tụ nhiều tên tuổi cũ quay về với rock như Da Vàng, Automega (phía Nam), Thủy Triều Đỏ, Gạt Tàn Đầy, The Light (phía Bắc)	['Tính', 'từ', 'thời điểm', 'đó', 'đến', 'nay', ',', 'nhiều', 'đại hội', 'rock', 'Việt', 'được', 'tổ chức', 'quy tụ', 'nhiều', 'tên tuổi', 'cũ', 'quay', 'về', 'với', 'rock', 'như', 'Da Vàng', ',', 'Automega', '(', 'phía', 'Nam', ')', ',', 'Thủy Triều Đỏ', ',', 'Gạt Tàn', 'Đầy', ',', 'The Light', '(', 'phía', 'Bắc', ')']
và sự hào hứng khẳng định của nhiều tên tuổi ban nhạc đàn em như Coming Late, Small Fire (Hà Nội), Sói Đen (Đà Nẵng), Limitted, Microware (TP	['và', 'sự', 'hào hứng', 'khẳng định', 'của', 'nhiều', 'tên tuổi', 'ban', 'nhạc', 'đàn em', 'như', 'Coming Late', ',', 'Small Fire', '(', 'Hà Nội', ')', ',', 'Sói', 'Đen', '(', 'Đà Nẵng', ')', ',', 'Limitted', ',', 'Microware', '(', 'TP']
3 album của Bức Tường bán chạy và thành cơn sốt thị	['3', 'album', 'của', 'Bức Tường', 'bán chạy', 'và', 'thành', 'cơn sốt', 'thị']
Đêm 11/11 tới, The Light và Bức Tường sẽ chia đều chương trình mỗi band 10 ca khúc	['Đêm', '11/11', 'tới', ',', 'The Light', 'và', 'Bức Tường', 'sẽ', 'chia đều', 'chương trình', 'mỗi', 'band', '10', 'ca khúc']
Ngoài những ca khúc quen thuộc trong các album đã phát hành của họ, mỗi band sẽ trình làng một vài ca khúc mới của mình	['Ngoài', 'những', 'ca khúc', 'quen thuộc', 'trong', 'các', 'album', 'đã', 'phát hành', 'của', 'họ', ',', 'mỗi', 'band', 'sẽ', 'trình làng', 'một vài', 'ca khúc', 'mới', 'của', 'mình']
Hai phần độc lập sẽ được kết nối bằng một cô gái chơi piano xuyên suốt - thay MC	['Hai', 'phần', 'độc lập', 'sẽ', 'được', 'kết nối', 'bằng', 'một', 'cô', 'gái', 'chơi', 'piano', 'xuyên', 'suốt', '-', 'thay', 'MC']
Chương trình sẽ diễn ra ngoài trời tại sân sau Triển lãm Giảng Võ với sức chứa trên 1 vạn người	['Chương trình', 'sẽ', 'diễn', 'ra', 'ngoài trời', 'tại', 'sân', 'sau', 'Triển lãm', 'Giảng Võ', 'với', 'sức chứa', 'trên', '1', 'vạn', 'người']
trường thực sự cũng làm nhiệt huyết của những nhà phát hành quan tâm	['trường', 'thực sự', 'cũng', 'làm', 'nhiệt huyết', 'của', 'những', 'nhà', 'phát hành', 'quan tâm']
The Light cũng ra mắt album đầu tay Giấc mơ hoang tàn (2004), Thủy Triều Đỏ cũng có album Nắng sớm	['The', 'Light', 'cũng', 'ra mắt', 'album', 'đầu tay', 'Giấc mơ', 'hoang tàn', '(', '2004', ')', ',', 'Thủy Triều Đỏ', 'cũng', 'có', 'album', 'Nắng', 'sớm']
Nhóm nhạc em út nhất Hà Nội là Small Fire cũng vừa Nam tiến thu album đầu tiên tại TP	['Nhóm', 'nhạc', 'em út', 'nhất', 'Hà Nội', 'là', 'Small Fire', 'cũng', 'vừa', 'Nam tiến', 'thu', 'album', 'đầu tiên', 'tại', 'TP']
Sự "hợp lưu" của dòng rock nặng nhiều âm thanh "chát chúa" (The Light) với dòng rock phổ cập và dễ nghe (Bức Tường) là một điều khôn ngoan	['Sự', '"', 'hợp lưu', '"', 'của', 'dòng', 'rock', 'nặng', 'nhiều', 'âm thanh', '"', 'chát chúa', '"', '(', 'The Light', ')', 'với', 'dòng', 'rock', 'phổ cập', 'và', 'dễ nghe', '(', 'Bức Tường', ')', 'là', 'một', 'điều', 'khôn ngoan']
Trước đây, sau mỗi thành công về mặt kinh doanh (băng đĩa - live show) của Bức Tường, lại nổi lên một phong trào đả kích từ phía những rockfan cực đoan	['Trước', 'đây', ',', 'sau', 'mỗi', 'thành công', 'về', 'mặt', 'kinh doanh', '(', 'băng đĩa', '-', 'live', 'show', ')', 'của', 'Bức Tường', ',', 'lại', 'nổi', 'lên', 'một', 'phong trào', 'đả kích', 'từ', 'phía', 'những', 'rockfan', 'cực đoan']
Họ cho rằng sự dung hòa, ve vuốt thị trường và khán giản của Bức Tường không phải là tính cách rock	['Họ', 'cho', 'rằng', 'sự', 'dung hòa', ',', 've vuốt', 'thị trường', 'và', 'khán giản', 'của', 'Bức', 'Tường', 'không', 'phải', 'là', 'tính cách', 'rock']
Rồi rock thì không thể đứng chung sân khấu với Đan Trường	['Rồi', 'rock', 'thì', 'không thể', 'đứng', 'chung', 'sân khấu', 'với', 'Đan', 'Trường']
Vì thế, trong một chương trình live show hoành tráng có sự liên kết giữa một điển hình của rock là The Light và một "ngôi sao thị trường" của rock là Bức Tường, rockfan có lẽ sẽ chẳng còn gì để phàn nàn cả	['Vì thế', ',', 'trong', 'một', 'chương trình', 'live', 'show', 'hoành tráng', 'có', 'sự', 'liên kết', 'giữa', 'một', 'điển hình', 'của', 'rock', 'là', 'The Light', 'và', 'một', '"', 'ngôi sao', 'thị trường', '"', 'của', 'rock', 'là', 'Bức Tường', ',', 'rockfan', 'có lẽ', 'sẽ', 'chẳng', 'còn', 'gì', 'để', 'phàn nàn', 'cả']
Những hòn đá lăn chính là ý tưởng của Bức Tường Productions	['Những', 'hòn', 'đá', 'lăn', 'chính', 'là', 'ý tưởng', 'của', 'Bức', 'Tường', 'Productions']
Theo như kế hoạch, sẽ còn có nhiều những "Những hòn đá lăn 2, 3, 4" tiếp theo nữa, tiếp tục "lăn" cùng những ban nhạc rock trẻ hơn như Small Fire hay Microware	['Theo', 'như', 'kế hoạch', ',', 'sẽ', 'còn', 'có', 'nhiều', 'những', '"', 'Những', 'hòn', 'đá', 'lăn', '2', ',', '3', ',', '4', '"', 'tiếp theo', 'nữa', ',', 'tiếp tục', '"', 'lăn', '"', 'cùng', 'những', 'ban', 'nhạc', 'rock', 'trẻ', 'hơn', 'như', 'Small Fire', 'hay', 'Microware']
Trọng Nghĩa: 'Người mẫu không chỉ biết nhún nhẩy'	['Trọng Nghĩa', ':', "'", 'Người mẫu', 'không', 'chỉ', 'biết', 'nhún nhẩy', "'"]
"Bất kỳ ngành nghề nào cũng có khúc quanh	['"', 'Bất kỳ', 'ngành nghề', 'nào', 'cũng', 'có', 'khúc', 'quanh']
Cũng chính vì những điều ồn ào đó mà tôi có dịp yên tĩnh để nhìn nhận bản thân và nghề nghiệp mình theo đuổi	['Cũng', 'chính', 'vì', 'những', 'điều', 'ồn ào', 'đó', 'mà', 'tôi', 'có', 'dịp', 'yên tĩnh', 'để', 'nhìn nhận', 'bản thân', 'và', 'nghề nghiệp', 'mình', 'theo đuổi']
Tôi không chọn sai đường, chỉ có điều đi thế nào để khỏi lọt ổ gà", người mẫu Trọng Nghĩa nói về những scandal giới người mẫu trong thời gian qua	['Tôi', 'không', 'chọn', 'sai', 'đường', ',', 'chỉ', 'có', 'điều', 'đi', 'thế nào', 'để', 'khỏi', 'lọt', 'ổ gà', '"', ',', 'người mẫu', 'Trọng Nghĩa', 'nói', 'về', 'những', 'scandal', 'giới', 'người mẫu', 'trong', 'thời gian', 'qua']
- Anh học được điều gì từ khi bước chân vào làng giải trí?	['-', 'Anh', 'học', 'được', 'điều', 'gì', 'từ', 'khi', 'bước', 'chân', 'vào', 'làng', 'giải trí', '?']
- Đã có rất nhiều anh chị người mẫu đi trước tôi sống và làm việc được bằng đồng tiền chân chính từ nghề	['-', 'Đã', 'có', 'rất', 'nhiều', 'anh chị', 'người mẫu', 'đi', 'trước', 'tôi', 'sống', 'và', 'làm việc', 'được', 'bằng', 'đồng tiền', 'chân chính', 'từ', 'nghề']
Sàn catwalk khôngphải luôn trải thảm nhung để tôi ung dung bước đi	['Sàn', 'catwalk', 'khôngphải', 'luôn', 'trải', 'thảm', 'nhung', 'để', 'tôi', 'ung dung', 'bước', 'đi']
Ở đó, tôi hình thành cá tính khi diễn, học cách giao tiếp với cộng đồng xung quanh, học được sự bình tĩnh với những cái nhìn còn cực đoan, nhiều định kiến với giới người mẫu chúng tôi	['Ở', 'đó', ',', 'tôi', 'hình thành', 'cá tính', 'khi', 'diễn', ',', 'học', 'cách', 'giao tiếp', 'với', 'cộng đồng', 'xung quanh', ',', 'học', 'được', 'sự', 'bình tĩnh', 'với', 'những', 'cái', 'nhìn', 'còn', 'cực đoan', ',', 'nhiều', 'định kiến', 'với', 'giới', 'người mẫu', 'chúng tôi']
- Nghề mẫu nam còn khá mới mẻ ở Việt Nam, do đó thu nhập không cao và không ổn định, có thể nói là không đủ sống	['-', 'Nghề', 'mẫu', 'nam', 'còn', 'khá', 'mới mẻ', 'ở', 'Việt Nam', ',', 'do đó', 'thu nhập', 'không', 'cao', 'và', 'không', 'ổn định', ',', 'có thể', 'nói', 'là', 'không', 'đủ', 'sống']
Công việc và thu nhập chính của tôi hiện nay là kinh doanh máy tính và các thiết bị văn phòng	['Công việc', 'và', 'thu nhập', 'chính', 'của', 'tôi', 'hiện nay', 'là', 'kinh doanh', 'máy tính', 'và', 'các', 'thiết bị', 'văn phòng']
Tôi bằng lòng với nghề tay trái ổn định để nuôi nghề tay phải vốn còn nhiều bấp bênh	['Tôi', 'bằng lòng', 'với', 'nghề', 'tay trái', 'ổn định', 'để', 'nuôi', 'nghề', 'tay', 'phải', 'vốn', 'còn', 'nhiều', 'bấp bênh']
- Giữa vóc dáng đẹp và tâm hồn đẹp, anh chọn cái nào?	['-', 'Giữa', 'vóc dáng', 'đẹp', 'và', 'tâm hồn', 'đẹp', ',', 'anh', 'chọn', 'cái', 'nào', '?']
- Tôi chọn vóc dáng đẹp, vì khi tôi biết nhận thức về cái đẹp, cái tốt, cái xấu tức là tâm hồn tôi cũng đẹp rồi	['-', 'Tôi', 'chọn', 'vóc dáng', 'đẹp', ',', 'vì', 'khi', 'tôi', 'biết', 'nhận thức', 'về', 'cái', 'đẹp', ',', 'cái', 'tốt', ',', 'cái', 'xấu', 'tức là', 'tâm hồn', 'tôi', 'cũng', 'đẹp', 'rồi']
-Đã bao giờ anh nghĩ công việc người mẫu chỉ là khoảnh khắc đẹp mà tuổi trẻ nào cũng muốn thử qua?	['-', 'Đã', 'bao giờ', 'anh', 'nghĩ', 'công việc', 'người mẫu', 'chỉ', 'là', 'khoảnh khắc', 'đẹp', 'mà', 'tuổi trẻ', 'nào', 'cũng', 'muốn', 'thử', 'qua', '?']
- Những ai hoạt động nghệ thuật đều ít nhiều có cảm tình với nghệ thuật	['-', 'Những ai', 'hoạt động', 'nghệ thuật', 'đều', 'ít nhiều', 'có', 'cảm tình', 'với', 'nghệ thuật']
Tôi yêu thích nghề người mẫu nhưng không dám khẳng định có hết mình vì nghề, sống chết với nghề hay không	['Tôi', 'yêu', 'thích', 'nghề', 'người mẫu', 'nhưng', 'không', 'dám', 'khẳng định', 'có', 'hết mình', 'vì', 'nghề', ',', 'sống chết', 'với', 'nghề', 'hay', 'không']
Điều đó còn chờ thời gian và những thử thách trước mắt	['Điều', 'đó', 'còn', 'chờ', 'thời gian', 'và', 'những', 'thử thách', 'trước', 'mắt']
- Người mẫu có cần cá tính và tạo scandal để nổi tiếng không?	['-', 'Người mẫu', 'có', 'cần', 'cá tính', 'và', 'tạo', 'scandal', 'để', 'nổi tiếng', 'không', '?']
- Tôi có nghe người khác bàn về cá tính, về scandal để dễ bề nổi tiếng	['-', 'Tôi', 'có', 'nghe', 'người', 'khác', 'bàn', 'về', 'cá tính', ',', 'về', 'scandal', 'để', 'dễ', 'bề', 'nổi tiếng']
Tôi nghĩ, dám tạo scandal để nâng mình lên, chắc chắn người đó đã là người cá tính	['Tôi', 'nghĩ', ',', 'dám', 'tạo', 'scandal', 'để', 'nâng', 'mình', 'lên', ',', 'chắc chắn', 'người', 'đó', 'đã', 'là', 'người', 'cá', 'tính']
Tôi vốn nhút nhát, nên chọn cho mình phương án thuận theo tự nhiên, như thế "ăn chắc mặc bền"	['Tôi', 'vốn', 'nhút nhát', ',', 'nên', 'chọn', 'cho', 'mình', 'phương án', 'thuận', 'theo', 'tự nhiên', ',', 'như thế', '"', 'ăn chắc', 'mặc', 'bền', '"']
- Anh nói sao về chuyện công chúng chê người mẫu chỉ biết nhún nhẩy và đi tới đi lui?	['-', 'Anh', 'nói', 'sao', 'về', 'chuyện', 'công chúng', 'chê', 'người mẫu', 'chỉ', 'biết', 'nhún nhẩy', 'và', 'đi', 'tới', 'đi', 'lui', '?']
- Kêu họ thử lên sân khấu nhún nhẩy xem có dễ không? Không phải tự nhiên mà người mẫu chúng tôi có những bước đi đó	['-', 'Kêu', 'họ', 'thử', 'lên', 'sân khấu', 'nhún nhẩy', 'xem', 'có', 'dễ', 'không', '?', 'Không', 'phải', 'tự nhiên', 'mà', 'người mẫu', 'chúng tôi', 'có', 'những', 'bước đi', 'đó']
Trái lại, phải học tập và rèn luyện rất khắc nghiệt	['Trái lại', ',', 'phải', 'học tập', 'và', 'rèn luyện', 'rất', 'khắc nghiệt']
- Thế còn những chê bai, so sánh đẳng cấp và các danh hiệu ảo của người mẫu?	['-', 'Thế', 'còn', 'những', 'chê bai', ',', 'so sánh', 'đẳng cấp', 'và', 'các', 'danh hiệu', 'ảo', 'của', 'người mẫu', '?']
- Nghệ thuật Việt Nam thường được đem so sánh với thế giới	['-', 'Nghệ thuật', 'Việt Nam', 'thường', 'được', 'đem', 'so sánh', 'với', 'thế giới']
So sánh để hướng thiện và làm tốt hơn thì nên	['So sánh', 'để', 'hướng thiện', 'và', 'làm', 'tốt', 'hơn', 'thì', 'nên']
Còn ngồi mà dè bỉu, chê bai, tính toán theo tôi là không nên	['Còn', 'ngồi', 'mà', 'dè bỉu', ',', 'chê bai', ',', 'tính toán', 'theo', 'tôi', 'là', 'không', 'nên']
Tất cả những gì mới mẻ, non nghề cần có quá trình thay da đổi thịt	['Tất cả', 'những', 'gì', 'mới mẻ', ',', 'non', 'nghề', 'cần', 'có', 'quá trình', 'thay da đổi', 'thịt']
Danh hiệu chẳng qua là danh phong trao tặng trong cuộc thi nhằm cạnh tranh lành mạnh	['Danh hiệu', 'chẳng qua', 'là', 'danh', 'phong', 'trao tặng', 'trong', 'cuộc', 'thi', 'nhằm', 'cạnh tranh', 'lành mạnh']
Mọi người đánh giá năng lực của người mẫu thông qua việc họ hoạt động hiệu quả và nghiêm túc như thế nào, chứ không phải qua một danh hiệu nhất thời	['Mọi', 'người', 'đánh giá', 'năng lực', 'của', 'người mẫu', 'thông qua', 'việc', 'họ', 'hoạt động', 'hiệu quả', 'và', 'nghiêm túc', 'như', 'thế nào', ',', 'chứ', 'không', 'phải', 'qua', 'một', 'danh hiệu', 'nhất thời']
- Anh nghĩ sao về ngành thời trang Việt Nam?	['-', 'Anh', 'nghĩ', 'sao', 'về', 'ngành', 'thời trang', 'Việt Nam', '?']
- Thời trang Việt Nam đang ngày càng hội nhập với thời trang thế giới	['-', 'Thời trang', 'Việt Nam', 'đang', 'ngày càng', 'hội nhập', 'với', 'thời trang', 'thế giới']
Đã có những thương hiệu nổi tiếng không những trong nước mà còn xuất khẩu ra nước ngoài	['Đã', 'có', 'những', 'thương hiệu', 'nổi tiếng', 'không những', 'trong', 'nước', 'mà còn', 'xuất khẩu', 'ra', 'nước ngoài']
Tôi nghĩ đó là tín hiệu đáng mừng cho sự khởi sắc	['Tôi', 'nghĩ', 'đó', 'là', 'tín hiệu', 'đáng', 'mừng', 'cho', 'sự', 'khởi sắc']
Cho một nhà bảo tàng, TT nghiên cứu Nguyễn Du, Truyện Kiều	['Cho', 'một', 'nhà', 'bảo tàng', ',', 'TT', 'nghiên cứu', 'Nguyễn Du', ',', 'Truyện Kiều']
Khắc phục mọi khó khăn, trong nhiều năm qua chúng ta đã bảo vệ, từng bước tôn tạo và định hình quần thể di tích Nguyễn Du và họ Nguyễn Tiên Ðiền - Nghi Xuân (Hà Tĩnh) với bảy điểm di tích chủ yếu là Nhà Tư văn (thờ Khổng Tử, dựng ở khu vườn ông tổ họ Nguyễn - Nhà thờ Nguyễn Du - Mộ Nguyễn Du - Ðàn tế và Bia kỷ niệm Nguyễn Quỳnh (ông nội) - Ðền thờ Nguyễn Nghiễm (cha) - Mộ Nguyễn Nghiễm - Ðền thờ Nguyễn Trọng (chú ruột)	['Khắc phục', 'mọi', 'khó khăn', ',', 'trong', 'nhiều', 'năm', 'qua', 'chúng ta', 'đã', 'bảo vệ', ',', 'từng', 'bước', 'tôn tạo', 'và', 'định hình', 'quần thể', 'di tích', 'Nguyễn Du', 'và', 'họ', 'Nguyễn Tiên Ðiền', '-', 'Nghi Xuân', '(', 'Hà Tĩnh', ')', 'với', 'bảy', 'điểm', 'di tích', 'chủ yếu', 'là', 'Nhà Tư văn', '(', 'thờ', 'Khổng Tử', ',', 'dựng', 'ở', 'khu', 'vườn', 'ông', 'tổ', 'họ', 'Nguyễn -', 'Nhà thờ', 'Nguyễn Du', '-', 'Mộ', 'Nguyễn Du', '-', 'Ðàn tế', 'và', 'Bia', 'kỷ niệm', 'Nguyễn Quỳnh', '(', 'ông', 'nội', ')', '-', 'Ðền', 'thờ', 'Nguyễn Nghiễm', '(', 'cha', ')', '-', 'Mộ', 'Nguyễn Nghiễm', '-', 'Ðền', 'thờ', 'Nguyễn Trọng', '(', 'chú ruột', ')']
Tính từ năm 2000, quần thể di tích này tiếp tục được Bộ Văn hóa - Thông tin cho lập dự án tôn tạo, trùng tu	['Tính', 'từ', 'năm', '2000', ',', 'quần thể', 'di tích', 'này', 'tiếp tục', 'được', 'Bộ Văn hóa', '-', 'Thông tin', 'cho', 'lập', 'dự án', 'tôn tạo', ',', 'trùng tu']
Ðặc biệt công trình Trung tâm Văn hóa Nguyễn Du cũng được đầu tư xây dựng mới trong khuôn viên khu lưu niệm với các hạng mục chính như tượng Nguyễn Du bằng đồng cao 6,5 m (tính từ bệ tượng) và các phòng hội thảo, thư viện, nhà trưng bày	['Ðặc', 'biệt', 'công trình', 'Trung tâm', 'Văn hóa', 'Nguyễn Du', 'cũng', 'được', 'đầu tư', 'xây dựng', 'mới', 'trong', 'khuôn viên', 'khu', 'lưu niệm', 'với', 'các', 'hạng mục', 'chính', 'như', 'tượng', 'Nguyễn Du', 'bằng', 'đồng', 'cao', '6,5', 'm', '(', 'tính', 'từ', 'bệ', 'tượng', ')', 'và', 'các', 'phòng', 'hội thảo', ',', 'thư viện', ',', 'nhà', 'trưng bày']
Ðược biết, Thủ tướng Chính phủ đã đồng ý cho lập và triển khai dự án Quy hoạch tổng thể khu văn hóa - du lịch Nguyễn Du - Tiên Ðiền	['Ðược', 'biết', ',', 'Thủ tướng', 'Chính phủ', 'đã', 'đồng ý', 'cho', 'lập', 'và', 'triển khai', 'dự án', 'Quy hoạch', 'tổng thể', 'khu', 'văn hóa', '-', 'du lịch', 'Nguyễn Du', '-', 'Tiên', 'Ðiền']
Có thể coi đây là cơ hội vàng cho việc tôn vinh danh nhân Nguyễn Du trên cả hai phương diện: bảo tồn và đi sâu khai thác, phát huy giá trị tinh thần của Nguyễn Du trong đời sống văn hóa đương đại	['Có thể', 'coi', 'đây', 'là', 'cơ hội', 'vàng', 'cho', 'việc', 'tôn vinh', 'danh nhân', 'Nguyễn Du', 'trên', 'cả', 'hai', 'phương diện', ':', 'bảo tồn', 'và', 'đi', 'sâu', 'khai thác', ',', 'phát huy', 'giá trị', 'tinh thần', 'của', 'Nguyễn Du', 'trong', 'đời sống', 'văn hóa', 'đương đại']
Trên thực tế, chúng ta đã xác định và cần xác định rõ hơn vị thế Khu di tích đại thi hào Nguyễn Du trong tương quan với "Quần thể di tích Nguyễn Du và họ Nguyễn Tiên Ðiền", rộng hơn là "Khu văn hóa - du lịch Nguyễn Du - Tiên Ðiền"	['Trên', 'thực tế', ',', 'chúng ta', 'đã', 'xác định', 'và', 'cần', 'xác định', 'rõ', 'hơn', 'vị thế', 'Khu', 'di tích', 'đại', 'thi hào', 'Nguyễn Du', 'trong', 'tương quan', 'với', '"', 'Quần thể', 'di tích', 'Nguyễn Du', 'và', 'họ', 'Nguyễn Tiên Ðiền', '"', ',', 'rộng', 'hơn', 'là', '"', 'Khu', 'văn hóa', '-', 'du lịch', 'Nguyễn Du', '-', 'Tiên Ðiền', '"']
Bên cạnh các điểm di tích vật thể có tính cố định, bất biến, thì hạt nhân của Khu di tích đại thi hào Nguyễn Du phải là Nhà Bảo tàng Nguyễn Du, thuộc loại hình "bảo tàng danh nhân" vốn phổ biến ở nhiều nước trên thế giới	['Bên cạnh', 'các', 'điểm', 'di tích', 'vật thể', 'có', 'tính', 'cố định', ',', 'bất biến', ',', 'thì', 'hạt nhân', 'của', 'Khu', 'di tích', 'đại', 'thi hào', 'Nguyễn Du', 'phải', 'là', 'Nhà', 'Bảo tàng', 'Nguyễn Du', ',', 'thuộc', 'loại hình', '"', 'bảo tàng', 'danh nhân', '"', 'vốn', 'phổ biến', 'ở', 'nhiều', 'nước', 'trên', 'thế giới']
Hiện nay, đã có nhà trưng bày lưu giữ nhiều tài liệu, hiện vật quý hiếm như chiếc la bàn Nguyễn Du dùng khi đi săn, bản Truyện Kiều chữ nôm cổ nhất khắc in năm 1866, cuốn Truyện Kiều độc bản viết theo lối thư pháp nặng 75 kg	['Hiện nay', ',', 'đã', 'có', 'nhà', 'trưng bày', 'lưu giữ', 'nhiều', 'tài liệu', ',', 'hiện vật', 'quý hiếm', 'như', 'chiếc', 'la bàn', 'Nguyễn Du', 'dùng', 'khi', 'đi', 'săn', ',', 'bản', 'Truyện Kiều', 'chữ', 'nôm', 'cổ', 'nhất', 'khắc', 'in', 'năm', '1866', ',', 'cuốn', 'Truyện Kiều', 'độc bản', 'viết', 'theo', 'lối', 'thư pháp', 'nặng', '75', 'kg']
Bên cạnh đó là phòng thư viện vừa chính thức khai trương ngày 26-11-2005	['Bên cạnh', 'đó', 'là', 'phòng', 'thư viện', 'vừa', 'chính thức', 'khai trương', 'ngày', '26-11-2005']
Ðược biết đến sự ra đời phòng thư viện, từ trước và đúng ngày khai trương, nhiều nhà nghiên cứu và sưu tập (Trần Phú Sơn, Nguyễn Hùng Vỹ, Ðào Tam Tỉnh, Nguyễn Khắc Bảo	['Ðược', 'biết', 'đến', 'sự', 'ra đời', 'phòng', 'thư viện', ',', 'từ', 'trước', 'và', 'đúng', 'ngày', 'khai trương', ',', 'nhiều', 'nhà', 'nghiên cứu', 'và', 'sưu tập', '(', 'Trần Phú Sơn', ',', 'Nguyễn Hùng Vỹ', ',', 'Ðào Tam Tỉnh', ',', 'Nguyễn Khắc Bảo']
) đã gửi tặng hàng trăm tài liệu, hiện vật, trong đó có nhiều bản Truyện Kiều chữ nôm cổ, Truyện Kiều bằng tiếng nước ngoài, nhiều tập thơ chữ Hán và các công trình nghiên cứu, giới thiệu về cuộc đời và sự nghiệp thơ văn Nguyễn Du	[')', 'đã', 'gửi', 'tặng', 'hàng', 'trăm', 'tài liệu', ',', 'hiện vật', ',', 'trong', 'đó', 'có', 'nhiều', 'bản', 'Truyện Kiều', 'chữ', 'nôm', 'cổ', ',', 'Truyện Kiều', 'bằng', 'tiếng', 'nước ngoài', ',', 'nhiều', 'tập', 'thơ', 'chữ', 'Hán', 'và', 'các', 'công trình', 'nghiên cứu', ',', 'giới thiệu', 'về', 'cuộc đời', 'và', 'sự nghiệp', 'thơ văn', 'Nguyễn Du']
Với niềm kính yêu Nguyễn Du và sự giúp đỡ của giới bạn đọc rộng rãi trong và ngoài nước, hy vọng rồi đây kho sách thư viện sẽ ngày một phong phú, đầy đủ hơn; nơi đây sẽ tập hợp được đầy đủ các loại văn bản Truyện Kiều (chữ nôm khắc in và viết tay, phiên âm quốc ngữ và dịch sang tiếng nước ngoài, chuyển thể tuồng, chèo, cải lương, truyện tranh	['Với', 'niềm', 'kính yêu', 'Nguyễn Du', 'và', 'sự', 'giúp đỡ', 'của', 'giới', 'bạn đọc', 'rộng rãi', 'trong', 'và', 'ngoài', 'nước', ',', 'hy vọng', 'rồi đây', 'kho', 'sách', 'thư viện', 'sẽ', 'ngày một', 'phong phú', ',', 'đầy đủ', 'hơn', ';', 'nơi', 'đây', 'sẽ', 'tập hợp', 'được', 'đầy đủ', 'các', 'loại', 'văn bản', 'Truyện Kiều', '(', 'chữ', 'nôm', 'khắc', 'in', 'và', 'viết tay', ',', 'phiên âm', 'quốc ngữ', 'và', 'dịch', 'sang', 'tiếng', 'nước ngoài', ',', 'chuyển thể', 'tuồng', ',', 'chèo', ',', 'cải lương', ',', 'truyện tranh']
) cũng như tất cả các công trình nghiên cứu chuyên sâu, luận văn, bài báo về Nguyễn Du và Truyện Kiều từ trước đến nay	[')', 'cũng', 'như', 'tất cả', 'các', 'công trình', 'nghiên cứu', 'chuyên sâu', ',', 'luận văn', ',', 'bài', 'báo', 'về', 'Nguyễn Du', 'và', 'Truyện Kiều', 'từ', 'trước', 'đến', 'nay']
Hơn nữa, việc xây dựng được một trang thông tin điện tử sẽ giúp độc giả tra cứu các nguồn tư liệu (tra cứu theo vần tên tác giả, theo tên mục bài, theo trật tự thời gian, theo chủ đề và chuyên ngành	['Hơn nữa', ',', 'việc', 'xây dựng', 'được', 'một', 'trang', 'thông tin', 'điện tử', 'sẽ', 'giúp', 'độc giả', 'tra cứu', 'các', 'nguồn', 'tư liệu', '(', 'tra cứu', 'theo', 'vần', 'tên', 'tác giả', ',', 'theo', 'tên', 'mục', 'bài', ',', 'theo', 'trật tự', 'thời gian', ',', 'theo', 'chủ đề', 'và', 'chuyên ngành']
), từ đó biết rõ những gì đã có và chưa có để tiếp tục sưu tập, bổ sung	[')', ',', 'từ', 'đó', 'biết', 'rõ', 'những', 'gì', 'đã', 'có', 'và', 'chưa', 'có', 'để', 'tiếp tục', 'sưu tập', ',', 'bổ sung']
Nơi đây cũng sẽ đóng vai trò lưu giữ và cung cấp tư liệu cho các nhà nghiên cứu trong nước và ngoài nước, phục vụ giới sinh viên, học sinh và đông đảo công chúng bạn đọc có nhu cầu tìm hiểu về Nguyễn Du	['Nơi', 'đây', 'cũng', 'sẽ', 'đóng', 'vai trò', 'lưu giữ', 'và', 'cung cấp', 'tư liệu', 'cho', 'các', 'nhà nghiên cứu', 'trong', 'nước', 'và', 'ngoài', 'nước', ',', 'phục vụ', 'giới', 'sinh viên', ',', 'học sinh', 'và', 'đông đảo', 'công chúng', 'bạn đọc', 'có', 'nhu cầu', 'tìm hiểu', 'về', 'Nguyễn Du']
Trên cơ sở nền tảng đời sống vật chất, nhu cầu đời sống tinh thần, mối quan tâm của dư luận xã hội và sự quan tâm thiết thực của các cấp các ngành như hiện nay, chúng tôi nghĩ đã đến lúc hội đủ điều kiện xây dựng và thành lập một tổ chức tương tự như Hội hay Trung tâm Nghiên cứu Nguyễn Du và Truyện Kiều, vinh danh đại thi hào dân tộc Nguyễn Du, như các nước trên thế giới đã vinh danh những Shakespeare, Tào Tuyết Cần, Puskin, Lermoltov, Walt Whitman, Tagore…	['Trên', 'cơ sở', 'nền tảng', 'đời sống', 'vật chất', ',', 'nhu cầu', 'đời sống', 'tinh thần', ',', 'mối', 'quan tâm', 'của', 'dư luận', 'xã hội', 'và', 'sự', 'quan tâm', 'thiết thực', 'của', 'các', 'cấp', 'các', 'ngành', 'như', 'hiện nay', ',', 'chúng tôi', 'nghĩ', 'đã', 'đến', 'lúc', 'hội', 'đủ', 'điều kiện', 'xây dựng', 'và', 'thành lập', 'một', 'tổ chức', 'tương tự', 'như', 'Hội', 'hay', 'Trung tâm', 'Nghiên cứu', 'Nguyễn Du', 'và', 'Truyện Kiều', ',', 'vinh danh', 'đại', 'thi hào', 'dân tộc', 'Nguyễn Du', ',', 'như', 'các', 'nước', 'trên', 'thế giới', 'đã', 'vinh danh', 'những', 'Shakespeare', ',', 'Tào Tuyết', 'Cần', ',', 'Puskin', ',', 'Lermoltov', ',', 'Walt Whitman', ',', 'Tagore', '…']
Quang Linh cố gắng 'làm sang' dòng nhạc dân ca	['Quang', 'Linh', 'cố gắng', "'", 'làm', 'sang', "'", 'dòng', 'nhạc', 'dân ca']
Cậu học trò mình trần quần đùi, tay ôm guitar, tay đưa nôi hát ru cháu ngủ	['Cậu', 'học trò', 'mình', 'trần', 'quần đùi', ',', 'tay', 'ôm', 'guitar', ',', 'tay', 'đưa', 'nôi', 'hát ru', 'cháu', 'ngủ']
Tiếng hát vang xa cả xóm, quen thuộc đến nỗi hôm nào có việc bận, bọn trẻ con chơi trước ngõ lại cứ ngóng tai chờ	['Tiếng', 'hát vang', 'xa', 'cả', 'xóm', ',', 'quen thuộc', 'đến nỗi', 'hôm', 'nào', 'có', 'việc', 'bận', ',', 'bọn', 'trẻ con', 'chơi', 'trước', 'ngõ', 'lại', 'cứ', 'ngóng', 'tai', 'chờ']
Đó là hình ảnh xưa của ca sĩ Quang Linh, người luôn tâm niệm "Phải làm sang trọng dòng nhạc dân ca"	['Đó', 'là', 'hình ảnh', 'xưa', 'của', 'ca sĩ', 'Quang Linh', ',', 'người', 'luôn', 'tâm niệm', '"', 'Phải', 'làm', 'sang trọng', 'dòng', 'nhạc', 'dân ca', '"']
Quang Linh là con thứ sáu trong gia đình có bảy anh chị em	['Quang Linh', 'là', 'con', 'thứ', 'sáu', 'trong', 'gia đình', 'có', 'bảy', 'anh chị em']
Nhà nghèo nên tất cả đều phải lao động sớm	['Nhà', 'nghèo', 'nên', 'tất cả', 'đều', 'phải', 'lao động', 'sớm']
Cậu học trò Quang Linh vừa lo chuyện học, vừa đảm trách chuyện chợ búa, cơm nước, giặt giũ cho cả nhà, chăm sóc cháu nhỏ cho chị gái đi làm, nuôi thêm một đàn lợn bốn con béo tốt	['Cậu', 'học trò', 'Quang Linh', 'vừa', 'lo', 'chuyện', 'học', ',', 'vừa', 'đảm trách', 'chuyện', 'chợ búa', ',', 'cơm nước', ',', 'giặt giũ', 'cho', 'cả', 'nhà', ',', 'chăm sóc', 'cháu', 'nhỏ', 'cho', 'chị gái', 'đi', 'làm', ',', 'nuôi', 'thêm', 'một', 'đàn', 'lợn', 'bốn', 'con', 'béo', 'tốt']
Niềm vui nhất của Quang Linh hồi ấy là được cùng người anh thứ hai Quang Sơn và người chị thứ tư Ngọc Bích (lúc đó đã là ca sĩ ở Huế) làm thành một "ban tam ca" hòa giọng vào những lúc rảnh rỗi	['Niềm', 'vui', 'nhất', 'của', 'Quang Linh', 'hồi', 'ấy', 'là', 'được', 'cùng', 'người', 'anh', 'thứ', 'hai', 'Quang Sơn', 'và', 'người', 'chị', 'thứ', 'tư', 'Ngọc Bích', '(', 'lúc', 'đó', 'đã', 'là', 'ca sĩ', 'ở', 'Huế', ')', 'làm', 'thành', 'một', '"', 'ban', 'tam ca', '"', 'hòa', 'giọng', 'vào', 'những', 'lúc', 'rảnh rỗi']
Một lần, anh phụ trách Nhà Văn hóa Lao động đến nhà gọi Quang Sơn đến hát gấp cho một chương trình văn nghệ, nhưng Sơn đi vắng	['Một', 'lần', ',', 'anh', 'phụ trách', 'Nhà Văn hóa', 'Lao động', 'đến', 'nhà', 'gọi', 'Quang Sơn', 'đến', 'hát', 'gấp', 'cho', 'một', 'chương trình', 'văn nghệ', ',', 'nhưng', 'Sơn', 'đi', 'vắng']
Người phụ trách từng nghe Quang Linh hát ru cháu bèn mạnh dạn nhờ Linh đi thay	['Người', 'phụ trách', 'từng', 'nghe', 'Quang Linh', 'hát ru', 'cháu', 'bèn', 'mạnh dạn', 'nhờ', 'Linh', 'đi', 'thay']
Tuy rất sợ vì chưa hát sân khấu bao giờ, nhưng thấy anh phụ trách nài nỉ quá nên Quang Linh nhận lời, chẳng ngờ được khán giả cổ vũ nồng nhiệt	['Tuy', 'rất', 'sợ', 'vì', 'chưa', 'hát', 'sân khấu', 'bao giờ', ',', 'nhưng', 'thấy', 'anh', 'phụ trách', 'nài nỉ', 'quá', 'nên', 'Quang Linh', 'nhận lời', ',', 'chẳng ngờ', 'được', 'khán giả', 'cổ vũ', 'nồng nhiệt']
Sau khi biết chuyện, cậu em bị ông anh cảnh cáo: "Ở nhà lo học hành đi, đừng ham hát hò mà khổ"	['Sau', 'khi', 'biết', 'chuyện', ',', 'cậu', 'em', 'bị', 'ông', 'anh', 'cảnh cáo', ':', '"', 'Ở', 'nhà', 'lo', 'học hành', 'đi', ',', 'đừng', 'ham', 'hát hò', 'mà', 'khổ', '"']
Tiền cát-xê lúc ấy rất thấp, một buổi diễn có khi chỉ đủ ăn vài quả trứng vịt lộn	['Tiền', 'cát', '-', 'xê', 'lúc', 'ấy', 'rất', 'thấp', ',', 'một', 'buổi', 'diễn', 'có khi', 'chỉ', 'đủ', 'ăn', 'vài', 'quả', 'trứng', 'vịt', 'lộn']
Một nhóm bạn chơi nhạc chuẩn bị tham gia "Cuộc thi các ban nhạc hay" cần giọng hát chính liền đến rủ Quang Linh	['Một', 'nhóm', 'bạn', 'chơi', 'nhạc', 'chuẩn bị', 'tham gia', '"', 'Cuộc', 'thi', 'các', 'ban', 'nhạc', 'hay', '"', 'cần', 'giọng', 'hát', 'chính', 'liền', 'đến', 'rủ Quang Linh']
Ban nhạc đoạt giải ban nhạc hay nhất, còn Quang Linh được các bạn khen: "Hát có hồn ghê hỉ"	['Ban', 'nhạc', 'đoạt', 'giải', 'ban', 'nhạc', 'hay', 'nhất', ',', 'còn', 'Quang Linh', 'được', 'các', 'bạn', 'khen', ':', '"', 'Hát', 'có', 'hồn', 'ghê', 'hỉ', '"']
Nghe lời anh chị, sau khi tốt nghiệp cấp ba, Quang Linh theo học trường Trung cấp Ngân hàng và làm việc tại Ngân hàng Công thương Huế	['Nghe', 'lời', 'anh chị', ',', 'sau', 'khi', 'tốt nghiệp', 'cấp', 'ba', ',', 'Quang Linh', 'theo', 'học', 'trường Trung cấp', 'Ngân hàng', 'và', 'làm việc', 'tại', 'Ngân hàng', 'Công thương', 'Huế']
Tại hội diễn văn nghệ phong trào, Quang Linh đoạt giải với hai ca khúc: Huế tình yêu của tôi và Bác Hồ một tình yêu bao la	['Tại', 'hội diễn', 'văn nghệ', 'phong trào', ',', 'Quang Linh', 'đoạt', 'giải', 'với', 'hai', 'ca khúc', ':', 'Huế', 'tình yêu', 'của', 'tôi', 'và', 'Bác Hồ', 'một', 'tình yêu', 'bao la']
Tại "Cuộc thi giọng hát hay miền Trung" tổ chức tại Huế, bạn bè đồng nghiệp ở ngân hàng xúi giọng ca vàng đơn vị mình đi thi, Quang Linh đoạt giải nhất với hai bài hát: Gửi Huế và Ngẫu hứng lý qua cầu	['Tại', '"', 'Cuộc', 'thi', 'giọng', 'hát', 'hay', 'miền', 'Trung', '"', 'tổ chức', 'tại', 'Huế', ',', 'bạn bè', 'đồng nghiệp', 'ở', 'ngân hàng', 'xúi', 'giọng', 'ca', 'vàng', 'đơn vị', 'mình', 'đi', 'thi', ',', 'Quang Linh', 'đoạt', 'giải', 'nhất', 'với', 'hai', 'bài', 'hát', ':', 'Gửi', 'Huế', 'và', 'Ngẫu hứng', 'lý', 'qua', 'cầu']
Cuộc đời Quang Linh tưởng sẽ gắn bó yên ổn mãi với nghề nhân viên ngân hàng nếu như giảng viên Lô Thanh (trường Âm nhạc Huế) không nhiệt tình giới thiệu học trò mình đến "Nhạc hội Gala ba miền", tổ chức tại Hà Nội năm 1990	['Cuộc đời', 'Quang Linh', 'tưởng', 'sẽ', 'gắn bó', 'yên ổn', 'mãi', 'với', 'nghề', 'nhân viên', 'ngân hàng', 'nếu như', 'giảng viên', 'Lô Thanh', '(', 'trường', 'Âm nhạc', 'Huế', ')', 'không', 'nhiệt tình', 'giới thiệu', 'học trò', 'mình', 'đến', '"', 'Nhạc', 'hội', 'Gala', 'ba', 'miền', '"', ',', 'tổ chức', 'tại', 'Hà Nội', 'năm', '1990']
Tại đây, Quang Linh được tiếp xúc, gần gũi với nhiều ca sĩ ngôi sao thời ấy như Ái Vân, Ngọc Tân	['Tại', 'đây', ',', 'Quang Linh', 'được', 'tiếp xúc', ',', 'gần gũi', 'với', 'nhiều', 'ca sĩ', 'ngôi sao', 'thời', 'ấy', 'như', 'Ái Vân', ',', 'Ngọc Tân']
Không khí rộn ràng và những tràng pháo tay nồng nhiệt ở các đêm gala đã khiến Quang Linh không thể ngồi yên ở ngân hàng được nữa	['Không khí', 'rộn ràng', 'và', 'những', 'tràng', 'pháo', 'tay', 'nồng nhiệt', 'ở', 'các', 'đêm', 'gala', 'đã', 'khiến', 'Quang Linh', 'không thể', 'ngồi', 'yên', 'ở', 'ngân hàng', 'được', 'nữa']
Anh quyết định đi theo con đường ca sĩ chuyên nghiệp	['Anh', 'quyết định', 'đi', 'theo', 'con', 'đường', 'ca sĩ', 'chuyên nghiệp']
Rời Huế, Quang Linh ra Hà Nội, thuê phòng trọ, bắt đầu cuộc hành trình mới	['Rời', 'Huế', ',', 'Quang Linh', 'ra', 'Hà Nội', ',', 'thuê', 'phòng', 'trọ', ',', 'bắt đầu', 'cuộc', 'hành trình', 'mới']
Anh tham gia tích cực như một thành viên của Nhà hát Ca múa nhạc Thăng Long	['Anh', 'tham gia', 'tích cực', 'như', 'một', 'thành viên', 'của', 'Nhà hát', 'Ca múa', 'nhạc', 'Thăng Long']
Nhưng TP HCM mới là nơi album giọng ca Quang Linh được cổ vũ mạnh nhất	['Nhưng', 'TP', 'HCM', 'mới', 'là', 'nơi', 'album', 'giọng', 'ca', 'Quang Linh', 'được', 'cổ vũ', 'mạnh', 'nhất']
Năm 1997, Quang Linh quyết định chuyển hẳn vào TP HCM sau 6 năm tạm cư tại Hà Nội	['Năm', '1997', ',', 'Quang Linh', 'quyết định', 'chuyển', 'hẳn', 'vào', 'TP', 'HCM', 'sau', '6', 'năm', 'tạm', 'cư', 'tại', 'Hà Nội']
Quang Linh hiện là ca sĩ duy nhất theo dòng nhạc âm hưởng dân ca có chương trình riêng ở các phòng trà TP HCM	['Quang', 'Linh', 'hiện', 'là', 'ca sĩ', 'duy nhất', 'theo', 'dòng', 'nhạc âm hưởng', 'dân ca', 'có', 'chương trình', 'riêng', 'ở', 'các', 'phòng', 'trà', 'TP', 'HCM']
Việt kiều ở bất cứ đâu, nghe có Quang Linh là yêu cầu được nghe dân ca	['Việt kiều', 'ở', 'bất cứ', 'đâu', ',', 'nghe', 'có', 'Quang Linh', 'là', 'yêu cầu', 'được', 'nghe', 'dân ca']
Con đường này anh đã tự vạch ra cho mình khi khoác ba lô rời Huế	['Con', 'đường', 'này', 'anh', 'đã', 'tự', 'vạch', 'ra', 'cho', 'mình', 'khi', 'khoác', 'ba lô', 'rời', 'Huế']
Ở xa nhìn về, anh thấy khuôn mặt của quê hương rõ hơn, sáng hơn và cũng ngọt ngào hơn với vốn liếng có được từ những đêm đắm mình ở Câu lạc bộ ca Huế, bên những nghệ sĩ Ái Hoa, Chiêu Dinh, Thúy Vân	['Ở', 'xa', 'nhìn', 'về', ',', 'anh', 'thấy', 'khuôn mặt', 'của', 'quê hương', 'rõ', 'hơn', ',', 'sáng', 'hơn', 'và', 'cũng', 'ngọt ngào', 'hơn', 'với', 'vốn liếng', 'có', 'được', 'từ', 'những', 'đêm', 'đắm mình', 'ở', 'Câu lạc bộ', 'ca Huế', ',', 'bên', 'những', 'nghệ sĩ', 'Ái Hoa', ',', 'Chiêu Dinh', ',', 'Thúy Vân']
Quang Linh luôn tự hào vì là người "sống được đàng hoàng" bằng dòng nhạc dân tộc	['Quang', 'Linh', 'luôn', 'tự hào', 'vì', 'là', 'người', '"', 'sống', 'được', 'đàng hoàng', '"', 'bằng', 'dòng', 'nhạc', 'dân tộc']
Với anh, đi hát trước hết là để được hát, được mang lại cảm xúc cho chính mình	['Với', 'anh', ',', 'đi', 'hát', 'trước hết', 'là', 'để', 'được', 'hát', ',', 'được', 'mang', 'lại', 'cảm xúc', 'cho', 'chính', 'mình']
Cuộc sống khó khăn trước kia không cho anh dám mơ ước gì hơn ngoài một công việc ổn định, đủ ăn đủ mặc	['Cuộc sống', 'khó khăn', 'trước kia', 'không', 'cho', 'anh', 'dám', 'mơ ước', 'gì', 'hơn', 'ngoài', 'một', 'công việc', 'ổn định', ',', 'đủ', 'ăn', 'đủ', 'mặc']
Bây giờ đã có chỗ đứng riêng, mua được nhà ở TP HCM, anh vẫn sống tình cảm thủy chung như xưa với chính mình và bạn bè, người thân	['Bây giờ', 'đã', 'có', 'chỗ', 'đứng', 'riêng', ',', 'mua', 'được', 'nhà', 'ở', 'TP', 'HCM', ',', 'anh', 'vẫn', 'sống', 'tình cảm', 'thủy chung', 'như', 'xưa', 'với', 'chính', 'mình', 'và', 'bạn bè', ',', 'người thân']
Chưa tìm được ai sẻ chia nên anh một mình làm tất cả mọi việc	['Chưa', 'tìm', 'được', 'ai', 'sẻ', 'chia', 'nên', 'anh', 'một mình', 'làm', 'tất cả', 'mọi', 'việc']
Rời sân khấu về nhà, anh vẫn là đứa con nhỏ của gia đình nặng phong cách Huế: nhận lời răn dạy hơn là lời khen	['Rời', 'sân khấu', 'về', 'nhà', ',', 'anh', 'vẫn', 'là', 'đứa', 'con', 'nhỏ', 'của', 'gia đình', 'nặng', 'phong cách', 'Huế', ':', 'nhận lời', 'răn', 'dạy', 'hơn', 'là', 'lời', 'khen']
Tết này, lần đầu tiên sau bao năm đi hát, Quang Linh mới tự cho phép mình được nghỉ ba ngày	['Tết', 'này', ',', 'lần', 'đầu tiên', 'sau', 'bao', 'năm', 'đi', 'hát', ',', 'Quang Linh', 'mới', 'tự', 'cho phép', 'mình', 'được', 'nghỉ', 'ba', 'ngày']
"Sẽ đưa "mạ" về Huế ăn Tết, sẽ về lại căn nhà ở xóm nhỏ phường Vĩnh Lợi của ngày xưa, lại sẽ được thoải mái mặc quần đùi đi long nhong khắp xóm", anh hí hửng khoe	['"', 'Sẽ', 'đưa', '"', 'mạ', '"', 'về', 'Huế', 'ăn Tết', ',', 'sẽ', 'về', 'lại', 'căn', 'nhà', 'ở', 'xóm', 'nhỏ', 'phường', 'Vĩnh Lợi', 'của', 'ngày xưa', ',', 'lại', 'sẽ', 'được', 'thoải mái', 'mặc', 'quần đùi', 'đi', 'long nhong', 'khắp', 'xóm', '"', ',', 'anh', 'hí hửng', 'khoe']
Aishwarya Rai bị nghi dính đến thế giới ngầm	['Aishwarya Rai', 'bị', 'nghi', 'dính', 'đến', 'thế giới', 'ngầm']
Cảnh sát Ấn Độ lấy khẩu cung của Hoa hậu Thế giới năm 1994 kiêm ngôi sao điện ảnh của Bollywood về những lời đồn đại rằng, diễn viên Salman Khan đã đe doạ "thịt" cô bằng thủ đoạn của mafia nếu cô không chịu biểu diễn trong show của một ông trùm	['Cảnh sát', 'Ấn Độ', 'lấy', 'khẩu cung', 'của', 'Hoa hậu Thế giới', 'năm', '1994', 'kiêm', 'ngôi sao', 'điện ảnh', 'của', 'Bollywood', 'về', 'những', 'lời', 'đồn đại', 'rằng', ',', 'diễn viên', 'Salman Khan', 'đã', 'đe doạ', '"', 'thịt', '"', 'cô', 'bằng', 'thủ đoạn', 'của', 'mafia', 'nếu', 'cô', 'không', 'chịu', 'biểu diễn', 'trong', 'show', 'của', 'một', 'ông', 'trùm']
Aishwarya bị tra hỏi tại nhà riêng của cô ở Mumbai	['Aishwarya', 'bị', 'tra hỏi', 'tại', 'nhà riêng', 'của', 'cô', 'ở', 'Mumbai']
Cảnh sát cũng ghi âm tiếng nói của cô để so sánh với một đoạn băng được cho là cuộc điện đàm giữa cô và Salman Khan, ghi âm năm 2001	['Cảnh sát', 'cũng', 'ghi âm', 'tiếng nói', 'của', 'cô', 'để', 'so sánh', 'với', 'một', 'đoạn', 'băng', 'được', 'cho', 'là', 'cuộc', 'điện đàm', 'giữa', 'cô', 'và', 'Salman Khan', ',', 'ghi âm', 'năm', '2001']
Trong đó, người được cho là Khan chửi rủa cô gái vì cô không muốn biểu diễn trong chương trình do bố già Abu Salem tổ chức	['Trong', 'đó', ',', 'người', 'được', 'cho', 'là', 'Khan', 'chửi rủa', 'cô', 'gái', 'vì', 'cô', 'không', 'muốn', 'biểu diễn', 'trong', 'chương trình', 'do', 'bố già', 'Abu Salem', 'tổ chức']
Girish Kulkarni, luật sư của Aishwarya Rai, nói: Cảnh sát đã thẩm vấn Rai trong 2 giờ và thái độ của cô là hoàn toàn hợp tác	['Girish Kulkarni', ',', 'luật sư', 'của', 'Aishwarya Rai', ',', 'nói', ':', 'Cảnh sát', 'đã', 'thẩm vấn', 'Rai', 'trong', '2', 'giờ', 'và', 'thái độ', 'của', 'cô', 'là', 'hoàn toàn', 'hợp tác']
Hôm chủ nhật, Salman Khan cũng được cảnh sát hỏi thăm trong vòng 4 giờ đồng hồ và cũng bị lấy mẫu ghi âm giọng nói	['Hôm', 'chủ nhật', ',', 'Salman Khan', 'cũng', 'được', 'cảnh sát', 'hỏi thăm', 'trong', 'vòng', '4', 'giờ', 'đồng hồ', 'và', 'cũng', 'bị', 'lấy', 'mẫu', 'ghi âm', 'giọng', 'nói']
Cả hai ngôi sao điện ảnh đều tuyên bố, giọng nói trong cuốn băng ghi âm đó không phải là của họ	['Cả', 'hai', 'ngôi sao', 'điện ảnh', 'đều', 'tuyên bố', ',', 'giọng', 'nói', 'trong', 'cuốn', 'băng', 'ghi âm', 'đó', 'không', 'phải', 'là', 'của', 'họ']
Phát biểu với báo chí, Salma Khan nói: Tôi bị dân xã hội đen đe doạ nên được cảnh sát bảo vệ từ năm 2002	['Phát biểu', 'với', 'báo chí', ',', 'Salma Khan', 'nói', ':', 'Tôi', 'bị', 'dân', 'xã hội', 'đen', 'đe doạ', 'nên', 'được', 'cảnh sát', 'bảo vệ', 'từ', 'năm', '2002']
Cảnh sát biết điều đó nên không thể có chuyện tôi dính dáng đến mafia	['Cảnh sát', 'biết', 'điều', 'đó', 'nên', 'không thể', 'có', 'chuyện', 'tôi', 'dính dáng', 'đến', 'mafia']
Diễn viên này tuyên bố, anh rất sốc khi đọc được những gì báo chí viết về mình và khẳng định, đó chỉ là những câu chuyện giật gân nhằm câu khách mà thôi	['Diễn viên', 'này', 'tuyên bố', ',', 'anh', 'rất', 'sốc', 'khi', 'đọc', 'được', 'những', 'gì', 'báo chí', 'viết', 'về', 'mình', 'và', 'khẳng định', ',', 'đó', 'chỉ', 'là', 'những', 'câu chuyện', 'giật gân', 'nhằm', 'câu khách', 'mà', 'thôi']
Anh còn doạ sẽ kiện tờ Hindustan Times vì đã đăng cuốn băng và đổ vạ đó là giọng của anh	['Anh', 'còn', 'doạ', 'sẽ', 'kiện', 'tờ', 'Hindustan Times', 'vì', 'đã', 'đăng', 'cuốn', 'băng', 'và', 'đổ vạ', 'đó', 'là', 'giọng', 'của', 'anh']
đã quyến rũ tôi Nhạc sĩ Nguyễn Cường Nhạc sĩ Nguyễn Cường đã nhận Tây Nguyên là quê hương thứ hai của mình, là vùng đất mà anh chịu ơn sâu nghĩa nặng	['đã', 'quyến rũ', 'tôi', 'Nhạc sĩ', 'Nguyễn Cường', 'Nhạc sĩ', 'Nguyễn Cường', 'đã', 'nhận', 'Tây Nguyên', 'là', 'quê hương', 'thứ', 'hai', 'của', 'mình', ',', 'là', 'vùng đất', 'mà', 'anh', 'chịu ơn', 'sâu', 'nghĩa', 'nặng']
Người Hà Nội, dân “Hàng Bạc xịn”, nhưng nhạc sĩ Nguyễn Cường nổi tiếng và được khán giả biết đến như là một nhạc sĩ Tây Nguyên, một người con của núi rừng Tây Nguyên	['Người', 'Hà Nội', ',', 'dân', '“', 'Hàng Bạc xịn', '”', ',', 'nhưng', 'nhạc sĩ', 'Nguyễn Cường', 'nổi tiếng', 'và', 'được', 'khán giả', 'biết', 'đến', 'như là', 'một', 'nhạc sĩ', 'Tây Nguyên', ',', 'một', 'người', 'con', 'của', 'núi rừng', 'Tây Nguyên']
Bằng âm hưởng đại ngàn hùng vĩ, Nguyễn Cường đã cuốn hút khán giả qua những ca khúc rất “thoáng”, rất hoang sơ nhưng đầy khao khát với nắng, gió và với cả	['Bằng', 'âm hưởng', 'đại ngàn', 'hùng vĩ', ',', 'Nguyễn Cường', 'đã', 'cuốn hút', 'khán giả', 'qua', 'những', 'ca khúc', 'rất', '“', 'thoáng', '”', ',', 'rất', 'hoang sơ', 'nhưng', 'đầy', 'khao khát', 'với', 'nắng', ',', 'gió', 'và', 'với', 'cả']
Phóng viên: Đã bao nhiêu ca khúc ra đời từ âm hưởng Tây Nguyên, thưa anh?	['Phóng viên', ':', 'Đã', 'bao nhiêu', 'ca khúc', 'ra đời', 'từ', 'âm hưởng', 'Tây Nguyên', ',', 'thưa', 'anh', '?']
- Nhạc sĩ Nguyễn Cường: Tôi nhớ không chính xác, nhưng bốn mươi năm qua, khoảng 60 ca khúc và tác phẩm khí nhạc đã ra đời trên âm hưởng những giai điệu dân gian của vùng đất ấy	['-', 'Nhạc sĩ', 'Nguyễn Cường', ':', 'Tôi', 'nhớ', 'không', 'chính xác', ',', 'nhưng', 'bốn mươi', 'năm', 'qua', ',', 'khoảng', '60', 'ca khúc', 'và', 'tác phẩm', 'khí nhạc', 'đã', 'ra đời', 'trên', 'âm hưởng', 'những', 'giai điệu', 'dân gian', 'của', 'vùng đất', 'ấy']
Mỗi lần đến, mỗi lần đi, cảm xúc lại đến, lại về, và một ca khúc mới ra đời	['Mỗi', 'lần', 'đến', ',', 'mỗi', 'lần', 'đi', ',', 'cảm xúc', 'lại', 'đến', ',', 'lại', 'về', ',', 'và', 'một', 'ca khúc', 'mới', 'ra đời']
- Sự gắn bó với Tây Nguyên gần như là một “cơ duyên” đã được định sẵn	['-', 'Sự', 'gắn bó', 'với', 'Tây Nguyên', 'gần', 'như', 'là', 'một', '“', 'cơ duyên', '”', 'đã', 'được', 'định', 'sẵn']
Năm 1964, khi tốt nghiệp trung cấp violoncelle Trường Âm nhạc Hà Nội, tôi đã được phân công về Đoàn Văn công Tây Nguyên và ở lại đó 2 năm	['Năm', '1964', ',', 'khi', 'tốt nghiệp', 'trung cấp', 'violoncelle', 'Trường', 'Âm nhạc', 'Hà Nội', ',', 'tôi', 'đã', 'được', 'phân công', 'về', 'Đoàn Văn công', 'Tây Nguyên', 'và', 'ở', 'lại', 'đó', '2', 'năm']
Ngay lập tức, cái nắng, cái gió, cà phê và cả màu đất đỏ bazan của vùng đất hoang sơ này đã quyến rũ tôi	['Ngay lập tức', ',', 'cái', 'nắng', ',', 'cái', 'gió', ',', 'cà phê', 'và', 'cả', 'màu', 'đất đỏ', 'bazan', 'của', 'vùng đất', 'hoang sơ', 'này', 'đã', 'quyến rũ', 'tôi']
Năm 1981, tôi và nhạc sĩ Trần Tiến quay lại vùng đất này	['Năm', '1981', ',', 'tôi', 'và', 'nhạc sĩ', 'Trần Tiến', 'quay', 'lại', 'vùng đất', 'này']
Ấn tượng mạnh mẽ nhất của tôi lúc ấy là được nghe người dân đánh chiêng trong một đêm uống rượu cần	['Ấn tượng', 'mạnh mẽ', 'nhất', 'của', 'tôi', 'lúc', 'ấy', 'là', 'được', 'nghe', 'người', 'dân', 'đánh', 'chiêng', 'trong', 'một', 'đêm', 'uống', 'rượu', 'cần']
Nhịp chiêng ấy đã tạo cho tôi cảm xúc để viết bài hát Nhịp chiêng buôn Kơ Siar với khúc mở đầu Đêm huyền thoại, đêm dừng lại, tôi nghe từ buôn Kơ Siar	['Nhịp', 'chiêng', 'ấy', 'đã', 'tạo', 'cho', 'tôi', 'cảm xúc', 'để', 'viết', 'bài', 'hát', 'Nhịp', 'chiêng', 'buôn', 'Kơ Siar', 'với', 'khúc', 'mở đầu', 'Đêm', 'huyền thoại', ',', 'đêm', 'dừng', 'lại', ',', 'tôi', 'nghe', 'từ', 'buôn', 'Kơ Siar']
Cũng năm 1981, ca khúc Hơ Zen lên rẫy của tôi đã được công chúng đón nhận khá là nồng nhiệt	['Cũng', 'năm', '1981', ',', 'ca khúc', 'Hơ', 'Zen', 'lên', 'rẫy', 'của', 'tôi', 'đã', 'được', 'công chúng', 'đón nhận', 'khá', 'là', 'nồng nhiệt']
Và có thể coi Nguyễn Cường= nắng+gió+cà phê	['Và', 'có thể', 'coi', 'Nguyễn Cường', '=', 'nắng', '+', 'gió', '+', 'cà phê']
Cuốn hút tôi, trước hết phải là con người Tây Nguyên, tâm hồn Tây Nguyên với những chàng trai, cô gái Bana, Êđê và nền âm nhạc cũng như văn hóa độc đáo của họ	['Cuốn hút', 'tôi', ',', 'trước hết', 'phải', 'là', 'con người', 'Tây Nguyên', ',', 'tâm hồn', 'Tây Nguyên', 'với', 'những', 'chàng', 'trai', ',', 'cô', 'gái', 'Bana', ',', 'Êđê', 'và', 'nền', 'âm nhạc', 'cũng', 'như', 'văn hóa', 'độc đáo', 'của', 'họ']
Gần như bất cứ điều gì của vùng đất này cũng tạo nên những cảm xúc rất mới lạ, ví như một lần Sở VHTT Đắk Lắk mời tôi lên Tây Nguyên tổ chức trại sáng tác	['Gần', 'như', 'bất cứ', 'điều', 'gì', 'của', 'vùng đất', 'này', 'cũng', 'tạo', 'nên', 'những', 'cảm xúc', 'rất', 'mới lạ', ',', 'ví như', 'một', 'lần', 'Sở', 'VHTT Đắk Lắk', 'mời', 'tôi', 'lên', 'Tây Nguyên', 'tổ chức', 'trại', 'sáng tác']
Mọi người ai cũng có tác phẩm, và tôi, với ấn tượng thật đặc biệt của lần trở về quê hương thứ hai của mình nên đã “viết mà như không” về một Còn thương nhau thì về Buôn Mê Thuột	['Mọi', 'người', 'ai', 'cũng', 'có', 'tác phẩm', ',', 'và', 'tôi', ',', 'với', 'ấn tượng', 'thật', 'đặc biệt', 'của', 'lần', 'trở', 'về', 'quê hương', 'thứ', 'hai', 'của', 'mình', 'nên', 'đã', '“', 'viết', 'mà', 'như', 'không', '”', 'về', 'một', 'Còn', 'thương', 'nhau', 'thì', 'về', 'Buôn Mê Thuột']
Câu đầu tiên gần như thốt lên “gặp lại em, mùa mưa, con đường xưa đây rồi	['Câu', 'đầu tiên', 'gần', 'như', 'thốt', 'lên', '“', 'gặp', 'lại', 'em', ',', 'mùa', 'mưa', ',', 'con', 'đường', 'xưa', 'đây', 'rồi']
Bài hát này, sau đó đã được khán giả rất thích, thậm chí một số người còn vui vẻ đặt lời tạo ra những “dị bản” rất hay	['Bài hát', 'này', ',', 'sau', 'đó', 'đã', 'được', 'khán giả', 'rất', 'thích', ',', 'thậm chí', 'một số', 'người', 'còn', 'vui vẻ', 'đặt', 'lời', 'tạo', 'ra', 'những', '“', 'dị bản', '”', 'rất', 'hay']
Con người và tâm hồn Tây Nguyên luôn là nguồn cảm hứng sáng tác của nhạc sĩ Nguyễn Cường	['Con người', 'và', 'tâm hồn', 'Tây Nguyên', 'luôn', 'là', 'nguồn', 'cảm hứng', 'sáng tác', 'của', 'nhạc sĩ', 'Nguyễn Cường']
Có sống mới hiểu, và có hiểu mới có những bài hát hay	['Có', 'sống', 'mới', 'hiểu', ',', 'và', 'có', 'hiểu', 'mới', 'có', 'những', 'bài', 'hát', 'hay']
Với vốn dắt lưng 60 tác phẩm, có thể nói là anh đã thực sự hiểu về mảnh đất, con người Tây Nguyên bí ẩn?	['Với', 'vốn', 'dắt', 'lưng', '60', 'tác phẩm', ',', 'có thể', 'nói', 'là', 'anh', 'đã', 'thực sự', 'hiểu', 'về', 'mảnh', 'đất', ',', 'con người', 'Tây Nguyên', 'bí ẩn', '?']
- Tôi phải thú thực là tôi chưa hiểu nhiều về Tây Nguyên, nhưng tôi cảm được vẻ đẹp của thiên nhiên, sự hiền hòa và thân thiện của con người nơi này	['-', 'Tôi', 'phải', 'thú thực', 'là', 'tôi', 'chưa', 'hiểu', 'nhiều', 'về', 'Tây Nguyên', ',', 'nhưng', 'tôi', 'cảm', 'được', 'vẻ', 'đẹp', 'của', 'thiên nhiên', ',', 'sự', 'hiền hòa', 'và', 'thân thiện', 'của', 'con người', 'nơi', 'này']
Chính vẻ đẹp ấy đã giúp tôi sáng tác không phải bằng cái đầu tỉnh táo mà là một trái tim nóng bỏng, trái tim ấy đã hòa nhịp với những người dân Tây Nguyên đáng yêu và rất thật thà	['Chính', 'vẻ', 'đẹp', 'ấy', 'đã', 'giúp', 'tôi', 'sáng tác', 'không', 'phải', 'bằng', 'cái', 'đầu', 'tỉnh táo', 'mà', 'là', 'một', 'trái tim', 'nóng bỏng', ',', 'trái tim', 'ấy', 'đã', 'hòa nhịp', 'với', 'những', 'người', 'dân', 'Tây Nguyên', 'đáng', 'yêu', 'và', 'rất', 'thật thà']
Và anh sẽ còn gắn bó với mảnh đất ấy? - Tất nhiên rồi	['Và', 'anh', 'sẽ', 'còn', 'gắn bó', 'với', 'mảnh', 'đất', 'ấy', '?', '-', 'Tất nhiên', 'rồi']
Tôi tuy sống ở Hà Nội nhưng vẫn đi đi-về về Tây Nguyên	['Tôi', 'tuy', 'sống', 'ở', 'Hà Nội', 'nhưng', 'vẫn', 'đi đi', '-', 'về', 'về', 'Tây Nguyên']
Vì đấy là quê hương thứ hai của tôi, là vùng đất mà tôi chịu ơn sâu nặng	['Vì', 'đấy', 'là', 'quê hương', 'thứ', 'hai', 'của', 'tôi', ',', 'là', 'vùng đất', 'mà', 'tôi', 'chịu ơn', 'sâu nặng']
Từng có người hỏi, tại sao Nguyễn Cường là người Hà Nội mà lại sáng tác nhạc Tây Nguyên? Câu trả lời rất đơn giản, chính vì tôi là người Hà Nội nên tôi mới sáng tác nhạc Tây Nguyên	['Từng', 'có', 'người', 'hỏi', ',', 'tại sao', 'Nguyễn Cường', 'là', 'người', 'Hà Nội', 'mà', 'lại', 'sáng tác', 'nhạc', 'Tây Nguyên', '?', 'Câu', 'trả lời', 'rất', 'đơn giản', ',', 'chính', 'vì', 'tôi', 'là', 'người', 'Hà Nội', 'nên', 'tôi', 'mới', 'sáng tác', 'nhạc', 'Tây Nguyên']
Vì Hà Nội là trung tâm của cả nước, cả nước hướng về Hà Nội và Hà Nội hướng ra cả nước	['Vì', 'Hà Nội', 'là', 'trung tâm', 'của', 'cả', 'nước', ',', 'cả', 'nước', 'hướng', 'về', 'Hà Nội', 'và', 'Hà Nội', 'hướng', 'ra', 'cả', 'nước']
O cục alô cho đẹp Thợ làm nail đang trang trí cho dế Nhiều chủ nhân thích o chiếc điện thoại di động của mình cho thật ấn tượng! Chính vì vậy mà những dịch vụ, sản phẩm làm đẹp cho chúng ngày càng nhiều	['O', 'cục', 'alô', 'cho', 'đẹp', 'Thợ', 'làm', 'nail', 'đang', 'trang trí', 'cho', 'dế', 'Nhiều', 'chủ nhân', 'thích', 'o', 'chiếc', 'điện thoại di động', 'của', 'mình', 'cho', 'thật', 'ấn tượng', '!', 'Chính', 'vì vậy', 'mà', 'những', 'dịch vụ', ',', 'sản phẩm', 'làm', 'đẹp', 'cho', 'chúng', 'ngày càng', 'nhiều']
Đáng chú ý là một dịch vụ mới xuất hiện gần đây, dịch vụ làm nail cho điện thoại di động	['Đáng', 'chú ý', 'là', 'một', 'dịch vụ', 'mới', 'xuất hiện', 'gần', 'đây', ',', 'dịch vụ', 'làm', 'nail', 'cho', 'điện thoại di động']
Với giới trẻ thì đây là cách làm đẹp cho "dế" đang thành "mốt"	['Với', 'giới', 'trẻ', 'thì', 'đây', 'là', 'cách', 'làm', 'đẹp', 'cho', '"', 'dế', '"', 'đang', 'thành', '"', 'mốt', '"']
Theo lời giới thiệu của một nhân viên bán hàng tại Samsung Mobile trên đường Trần Quốc Thảo, chúng tôi đã tìm đến trung tâm nail có tên là Kelly Pang (110 Trần Hưng Đạo, Q	['Theo', 'lời', 'giới thiệu', 'của', 'một', 'nhân viên', 'bán', 'hàng', 'tại', 'Samsung Mobile', 'trên', 'đường', 'Trần Quốc Thảo', ',', 'chúng tôi', 'đã', 'tìm', 'đến', 'trung tâm', 'nail', 'có', 'tên', 'là', 'Kelly Pang', '(', '110', 'Trần Hưng Đạo', ',', 'Q']
Ở đây, giá thấp nhất mỗi lần làm nail cho dế là 200	['Ở', 'đây', ',', 'giá', 'thấp', 'nhất', 'mỗi', 'lần', 'làm', 'nail', 'cho', 'dế', 'là', '200']
000đ tuỳ theo độ khó và số lượng vật liệu dùng cho chiếc điện thoại	['000đ', 'tuỳ', 'theo', 'độ', 'khó', 'và', 'số lượng', 'vật liệu', 'dùng', 'cho', 'chiếc', 'điện thoại']
Chị Pang Mỹ Linh, giám đốc của Kelly Pang cho biết, mỗi ngày chỉ làm tối đa được 5 chiếc	['Chị', 'Pang', 'Mỹ Linh', ',', 'giám đốc', 'của', 'Kelly Pang', 'cho', 'biết', ',', 'mỗi', 'ngày', 'chỉ', 'làm', 'tối đa', 'được', '5', 'chiếc']
Tuỳ kiểu điện thoại mà tư vấn khách hàng chọn cách trang trí thích hợp	['Tuỳ', 'kiểu', 'điện thoại', 'mà', 'tư vấn', 'khách hàng', 'chọn', 'cách', 'trang trí', 'thích hợp']
Với những model điện thoại có kiểu dáng vỏ sò hoặc dạng trượt thì dễ trang trí vì chúng có diện tích khoảng trống lớn	['Với', 'những', 'model', 'điện thoại', 'có', 'kiểu dáng', 'vỏ sò', 'hoặc', 'dạng', 'trượt', 'thì', 'dễ', 'trang trí', 'vì', 'chúng', 'có', 'diện tích', 'khoảng trống', 'lớn']
Còn các model dạng bar (dạng thanh) thì chỉ được gắn đá màu cốt để làm duyên	['Còn', 'các', 'model', 'dạng', 'bar', '(', 'dạng', 'thanh', ')', 'thì', 'chỉ', 'được', 'gắn', 'đá', 'màu', 'cốt', 'để', 'làm duyên']
Ngoài những mẫu có sẵn, khách hàng có thể sáng tạo mẫu theo ý thích riêng	['Ngoài', 'những', 'mẫu', 'có', 'sẵn', ',', 'khách hàng', 'có thể', 'sáng tạo', 'mẫu', 'theo', 'ý', 'thích', 'riêng']
Căn cứ vào vật liệu sử dụng, Kelly Pang sẽ tính giá với khách để hai bên thoả thuận trước khi nail cho dế!	['Căn cứ', 'vào', 'vật liệu', 'sử dụng', ',', 'Kelly Pang', 'sẽ', 'tính', 'giá', 'với', 'khách', 'để', 'hai', 'bên', 'thoả thuận', 'trước', 'khi', 'nail', 'cho', 'dế', '!']
Cũng theo chị Linh, làm nail cho dế mới ra đời cách đây 5 tháng sau khi chị học được từ các cô gái Nhật Bản trong thời gian chị học nghề nail ở đây	['Cũng', 'theo', 'chị', 'Linh', ',', 'làm', 'nail', 'cho', 'dế', 'mới', 'ra đời', 'cách', 'đây', '5', 'tháng', 'sau', 'khi', 'chị', 'học', 'được', 'từ', 'các', 'cô', 'gái', 'Nhật Bản', 'trong', 'thời gian', 'chị', 'học', 'nghề', 'nail', 'ở', 'đây']
Hiện không chỉ riêng có Kelly Pang, nhiều tiệm nail ở Sài Gòn đã làm được dịch vụ này vì thao tác khá đơn giản, trong khi số lượng khách hàng có nhu cầu làm đẹp cho dế ngày càng tăng	['Hiện', 'không', 'chỉ', 'riêng', 'có', 'Kelly Pang', ',', 'nhiều', 'tiệm', 'nail', 'ở', 'Sài Gòn', 'đã', 'làm', 'được', 'dịch vụ', 'này', 'vì', 'thao tác', 'khá', 'đơn giản', ',', 'trong', 'khi', 'số lượng', 'khách hàng', 'có', 'nhu cầu', 'làm', 'đẹp', 'cho', 'dế', 'ngày càng', 'tăng']
Cũng có nhiều người chọn cách mua những đồ trang trí có sẵn đang bán trên thị trường để làm đẹp cho điện thoại	['Cũng', 'có', 'nhiều', 'người', 'chọn', 'cách', 'mua', 'những', 'đồ', 'trang trí', 'có', 'sẵn', 'đang', 'bán', 'trên', 'thị trường', 'để', 'làm', 'đẹp', 'cho', 'điện thoại']
Hàng được bán nhiều tại các cửa hàng bán điện thoại di động trên đường Hùng Vương, Nguyễn Tri Phương, Nguyễn Chí Thanh	['Hàng', 'được', 'bán', 'nhiều', 'tại', 'các', 'cửa hàng', 'bán', 'điện thoại di động', 'trên', 'đường', 'Hùng Vương', ',', 'Nguyễn Tri Phương', ',', 'Nguyễn Chí Thanh']
Một nhóm bạn trẻ sà vào quầy kính tại cửa hàng số 2 trên đường Hùng Vương để chọn những chiếc đèn báo tín hiệu có giá 20	['Một', 'nhóm', 'bạn', 'trẻ', 'sà', 'vào', 'quầy', 'kính', 'tại', 'cửa hàng', 'số', '2', 'trên', 'đường', 'Hùng Vương', 'để', 'chọn', 'những', 'chiếc', 'đèn báo', 'tín hiệu', 'có', 'giá', '20']
000đ, còn dây đeo sặc sỡ sắc màu có giá từ 5	['000đ', ',', 'còn', 'dây đeo', 'sặc sỡ', 'sắc màu', 'có', 'giá', 'từ', '5']
000đ tuỳ theo chất liệu dây bằng nhựa mềm hay bằng sợi	['000đ', 'tuỳ', 'theo', 'chất liệu', 'dây', 'bằng', 'nhựa', 'mềm', 'hay', 'bằng', 'sợi']
Một "thiết bị" cũng được các bạn trẻ quan tâm là hình thú ngộ nghĩnh trên những tấm giấy đề-can có giá 5	['Một', '"', 'thiết bị', '"', 'cũng', 'được', 'các', 'bạn', 'trẻ', 'quan tâm', 'là', 'hình', 'thú', 'ngộ nghĩnh', 'trên', 'những', 'tấm', 'giấy', 'đề', '-', 'can', 'có', 'giá', '5']
Nam giới lại quan tâm đến những chiếc bao da	['Nam giới', 'lại', 'quan tâm', 'đến', 'những', 'chiếc', 'bao', 'da']
Muốn mua hàng chính hãng hãy đến các siêu thị ĐTDĐ lớn với giá từ 200	['Muốn', 'mua', 'hàng', 'chính', 'hãng', 'hãy', 'đến', 'các', 'siêu thị', 'ĐTDĐ', 'lớn', 'với', 'giá', 'từ', '200']
000đ tuỳ theo model điện thoại và kiểu dáng, chất liệu của bao da	['000đ', 'tuỳ', 'theo', 'model', 'điện thoại', 'và', 'kiểu dáng', ',', 'chất liệu', 'của', 'bao', 'da']
000đ, cứ đến các cửa hàng nhỏ, lúc nào cũng sẵn	['000đ', ',', 'cứ', 'đến', 'các', 'cửa hàng', 'nhỏ', ',', 'lúc nào', 'cũng', 'sẵn']
Một cách làm đẹp khác cũng còn được nhiều bạn trẻ quan tâm là thay đổi hệ thống đèn hình trên máy	['Một', 'cách', 'làm', 'đẹp', 'khác', 'cũng', 'còn', 'được', 'nhiều', 'bạn', 'trẻ', 'quan tâm', 'là', 'thay đổi', 'hệ thống', 'đèn hình', 'trên', 'máy']
Mà không phải máy nào cũng dễ dàng thay thế đèn	['Mà', 'không', 'phải', 'máy', 'nào', 'cũng', 'dễ dàng', 'thay thế', 'đèn']
Hiện nay chỉ các dòng máy "Noki" mới dễ dàng thay đèn hình	['Hiện nay', 'chỉ', 'các', 'dòng', 'máy', '"', 'Noki', '"', 'mới', 'dễ dàng', 'thay', 'đèn hình']
Các dòng máy khác như Samsung, Sony Ericsson	['Các', 'dòng', 'máy', 'khác', 'như', 'Samsung', ',', 'Sony Ericsson']
thì phải nhờ đến các chuyên viên kỹ thuật của các trung tâm bảo hành chính hãng	['thì', 'phải', 'nhờ', 'đến', 'các', 'chuyên viên', 'kỹ thuật', 'của', 'các', 'trung tâm', 'bảo hành chính', 'hãng']
Một chủ cửa hàng trên đường Hùng Vương cho biết, cách đây vài năm, bán điện thoại không ngon bằng bán "ba cái thứ lặt vặt" này	['Một', 'chủ', 'cửa hàng', 'trên', 'đường', 'Hùng Vương', 'cho', 'biết', ',', 'cách', 'đây', 'vài', 'năm', ',', 'bán', 'điện thoại', 'không', 'ngon', 'bằng', 'bán', '"', 'ba', 'cái', 'thứ', 'lặt vặt', '"', 'này']
Bây giờ tốc độ bán có chậm lại nhưng vẫn còn kiếm sống được	['Bây giờ', 'tốc độ', 'bán', 'có', 'chậm', 'lại', 'nhưng', 'vẫn', 'còn', 'kiếm', 'sống', 'được']
Trung Quốc co kha nhiêu trương phai nâu ăn	['Trung Quốc', 'co', 'kha', 'nhiêu', 'trương', 'phai', 'nâu', 'ăn']
Trong đo, nhưng trương phai co anh hương va mang tinh đai diên nhât đươc ca xa hôi công nhân la cac mon ăn cua Sơn Đông, Tư Xuyên, Quang Đông, Phuc Kiên, Giang Tô, Chiêt Giang, Hô Nam va An Huy	['Trong', 'đo', ',', 'nhưng', 'trương', 'phai', 'co', 'anh', 'hương', 'va', 'mang', 'tinh đai', 'diên', 'nhât', 'đươc', 'ca', 'xa', 'hôi', 'công nhân', 'la', 'cac', 'mon', 'ăn', 'cua', 'Sơn Đông', ',', 'Tư Xuyên', ',', 'Quang Đông', ',', 'Phuc Kiên', ',', 'Giang Tô', ',', 'Chiêt Giang', ',', 'Hô', 'Nam', 'va', 'An Huy']
Sư hinh thanh cua môt trương phai co lich sư lâu dai không thê tach rơi vơi viêc nâu ăn đăc săc va đôc đao	['Sư', 'hinh', 'thanh', 'cua', 'môt', 'trương', 'phai', 'co', 'lich', 'sư', 'lâu', 'dai', 'không', 'thê', 'tach', 'rơi', 'vơi', 'viêc', 'nâu', 'ăn', 'đăc', 'săc', 'va', 'đôc', 'đao']
Đông thơi, no cung chiu sư anh hương cua đia dư, điêu kiên khi hâu, đăc san tai nguyên, thoi quen ăn uông	['Đông', 'thơi', ',', 'no', 'cung', 'chiu', 'sư', 'anh', 'hương', 'cua', 'đia', 'dư', ',', 'điêu', 'kiên', 'khi', 'hâu', ',', 'đăc', 'san', 'tai', 'nguyên', ',', 'thoi', 'quen', 'ăn', 'uông']
Co ngươi đa vi môt cach nhân cach hoa vê 8 trương phai mon ăn nay như sau: mon ăn cua Giang Tô, Chiêt Giang co khac nao ngươi đep; Giang Nam thanh tu; mon ăn cua Sơn Đông, An Huy la môt trang nam nhi môc mac chât phac; mon ăn cua Quang Đông, Phuc Kiên thi nha nhăn như vi công tư phong lưu con mon ăn cua Tư Xuyên, Hô Nam thi chăng khac nao môt vi danh si tai ba	['Co', 'ngươi', 'đa', 'vi', 'môt', 'cach', 'nhân', 'cach', 'hoa', 'vê', '8', 'trương', 'phai', 'mon', 'ăn', 'nay', 'như', 'sau', ':', 'mon', 'ăn', 'cua Giang Tô', ',', 'Chiêt Giang', 'co', 'khac', 'nao', 'ngươi', 'đep', ';', 'Giang Nam thanh', 'tu', ';', 'mon', 'ăn', 'cua', 'Sơn Đông', ',', 'An Huy la', 'môt', 'trang', 'nam nhi', 'môc', 'mac', 'chât', 'phac', ';', 'mon', 'ăn', 'cua', 'Quang Đông', ',', 'Phuc Kiên', 'thi', 'nha', 'nhăn', 'như', 'vi', 'công tư', 'phong lưu', 'con', 'mon', 'ăn', 'cua', 'Tư Xuyên', ',', 'Hô Nam', 'thi', 'chăng', 'khac', 'nao', 'môt', 'vi danh', 'si', 'tai', 'ba']
Trương phai: Gôm hai loai mon ăn Tê Nam va Dao Đông	['Trương phai', ':', 'Gôm', 'hai', 'loai', 'mon', 'ăn', 'Tê Nam', 'va', 'Dao', 'Đông']
Đăc điêm: Vi nông đâm, năng mui hanh toi, nhât la mon hai san, co sơ trương lam mon canh va nôi tang đông vât	['Đăc', 'điêm', ':', 'Vi', 'nông', 'đâm', ',', 'năng', 'mui', 'hanh', 'toi', ',', 'nhât', 'la', 'mon', 'hai', 'san', ',', 'co', 'sơ', 'trương', 'lam', 'mon', 'canh', 'va', 'nôi', 'tang', 'đông', 'vât']
Mon ăn co tiêng: ốc kho, ca chep chua ngot	['Mon', 'ăn', 'co', 'tiêng', ':', 'ốc', 'kho', ',', 'ca', 'chep', 'chua', 'ngot']
Trương phai: Gôm hai trương phai Thanh Đô va Trung Khanh	['Trương phai', ':', 'Gôm', 'hai', 'trương', 'phai', 'Thanh', 'Đô', 'va', 'Trung Khanh']
Mon ăn co tiêng: vây ca kho khô, cua xao thơm cay	['Mon', 'ăn', 'co', 'tiêng', ':', 'vây', 'ca', 'kho', 'khô', ',', 'cua', 'xao', 'thơm', 'cay']
Trương phai: Gôm mon ăn cua cac đia phương Dương Châu, Tô Châu va Nam Kinh	['Trương phai', ':', 'Gôm', 'mon', 'ăn', 'cua', 'cac', 'đia', 'phương', 'Dương Châu', ',', 'Tô Châu va', 'Nam Kinh']
Đăc điêm: Nổi tiếng về các mon hâm, ninh, tân	['Đăc', 'điêm', ':', 'Nổi tiếng', 'về', 'các', 'mon', 'hâm', ',', 'ninh', ',', 'tân']
Chu trong vê mon canh, bảo đam nguyên chât nguyên vi	['Chu', 'trong', 'vê', 'mon', 'canh', ',', 'bảo', 'đam', 'nguyên', 'chât', 'nguyên', 'vi']
Mon ăn co tiêng: mon thit va thit cua hâp	['Mon', 'ăn', 'co', 'tiêng', ':', 'mon', 'thit', 'va', 'thit', 'cua', 'hâp']
Trương phai: Gôm cac mon ăn cua Hang Châu, Ninh Ba, Thiêu Hưng	['Trương phai', ':', 'Gôm', 'cac', 'mon', 'ăn', 'cua', 'Hang Châu', ',', 'Ninh Ba', ',', 'Thiêu', 'Hưng']
Nhưng co tiêng tăm nhât la mon ăn cua Hang Châu	['Nhưng', 'co', 'tiêng', 'tăm', 'nhât', 'la', 'mon', 'ăn', 'cua', 'Hang Châu']
Đăc điêm: mon ăn tươi mêm, thanh đam, không ngây	['Đăc', 'điêm', ':', 'mon', 'ăn tươi', 'mêm', ',', 'thanh', 'đam', ',', 'không', 'ngây']
Mon ăn co tiêng: tôm non Long Tinh, ca chep Tây Hô	['Mon', 'ăn', 'co', 'tiêng', ':', 'tôm', 'non', 'Long Tinh', ',', 'ca', 'chep', 'Tây', 'Hô']
Trương phai: Gôm ba trương phai Quang Châu, Triêu Châu va Đông Giang, mon ăn Quang Châu nổi tiếng nhất	['Trương phai', ':', 'Gôm', 'ba', 'trương', 'phai', 'Quang Châu', ',', 'Triêu Châu', 'va', 'Đông Giang', ',', 'mon', 'ăn', 'Quang Châu', 'nổi tiếng', 'nhất']
Đăc điêm: Rât sành vê cac mon chiên, ran, hâm	['Đăc', 'điêm', ':', 'Rât', 'sành', 'vê', 'cac', 'mon', 'chiên', ',', 'ran', ',', 'hâm']
Mon ăn co tiêng: Tam xa long hô phương, lơn quay	['Mon', 'ăn', 'co', 'tiêng', ':', 'Tam', 'xa', 'long', 'hô', 'phương', ',', 'lơn', 'quay']
Trương phai: Gôm cac mon ăn Phuc Châu, Tuyên Châu va Ha Môn	['Trương phai', ':', 'Gôm', 'cac', 'mon', 'ăn', 'Phuc Châu', ',', 'Tuyên Châu', 'va', 'Ha Môn']
Đăc điêm: Nguyên liêu chu yêu la hai san, chu trong vi ngot chua măn thơm, mau đep vi tươi	['Đăc', 'điêm', ':', 'Nguyên', 'liêu', 'chu', 'yêu', 'la', 'hai', 'san', ',', 'chu', 'trong', 'vi', 'ngot', 'chua', 'măn', 'thơm', ',', 'mau', 'đep', 'vi', 'tươi']
Mon ăn co tiêng: Kim phuc tho, ca kho khô	['Mon', 'ăn', 'co', 'tiêng', ':', 'Kim', 'phuc', 'tho', ',', 'ca', 'kho', 'khô']
Trương phai: Chu trong thơm cay, tê cay, chua, cay va tươi	['Trương phai', ':', 'Chu', 'trong', 'thơm', 'cay', ',', 'tê', 'cay', ',', 'chua', ',', 'cay', 'va', 'tươi']
Trương phai: Gôm cac mon ăn cua miên nam An Huy, cung như khu vưc doc sông Trương Giang va Hoai hà	['Trương phai', ':', 'Gôm', 'cac', 'mon', 'ăn', 'cua', 'miên', 'nam', 'An Huy', ',', 'cung', 'như', 'khu', 'vưc', 'doc', 'sông', 'Trương Giang va', 'Hoai', 'hà']
Nhưng vơi cac mon ăn cua vung miên nam An Huy la chinh	['Nhưng', 'vơi', 'cac', 'mon', 'ăn', 'cua', 'vung', 'miên', 'nam', 'An Huy la', 'chinh']
Đăc điêm: Co sơ trương vê cac mon ninh, hâm	['Đăc', 'điêm', ':', 'Co', 'sơ', 'trương', 'vê', 'cac', 'mon', 'ninh', ',', 'hâm']
Trong 8 trương phai ẩm thực cua TQ thi mon ăn cua Tư Xuyên la đươc phô biên rông rai nhât	['Trong', '8', 'trương', 'phai', 'ẩm thực', 'cua', 'TQ', 'thi', 'mon', 'ăn', 'cua', 'Tư Xuyên la', 'đươc', 'phô', 'biên', 'rông', 'rai', 'nhât']
Mon ăn Tư Xuyên co lich sư lâu dai, hương vi đôc đao, rât co tiêng tăm ơ trong va ngoai nươc	['Mon', 'ăn', 'Tư Xuyên co', 'lich', 'sư', 'lâu', 'dai', ',', 'hương', 'vi', 'đôc', 'đao', ',', 'rât', 'co', 'tiêng', 'tăm', 'ơ', 'trong', 'va', 'ngoai', 'nươc']
No đăc biêt chu trong vê săc, hương, vi, hinh, nhât la co kha nhiêu vi va nông đâm gôm: tê, cay, măn, ngot, chua, đăng, thơm, trôn lân kheo leo, biên hoa linh hoat, đa pha chê ra mây chuc vi phưc hơp rât đôc đao như: tê cay, chua cay, dâu đo, dâu trăng	['No', 'đăc', 'biêt', 'chu', 'trong', 'vê', 'săc', ',', 'hương', ',', 'vi', ',', 'hinh', ',', 'nhât', 'la', 'co', 'kha', 'nhiêu', 'vi', 'va', 'nông', 'đâm', 'gôm', ':', 'tê', ',', 'cay', ',', 'măn', ',', 'ngot', ',', 'chua', ',', 'đăng', ',', 'thơm', ',', 'trôn', 'lân', 'kheo', 'leo', ',', 'biên', 'hoa', 'linh', 'hoat', ',', 'đa', 'pha', 'chê', 'ra', 'mây', 'chuc', 'vi', 'phưc', 'hơp', 'rât', 'đôc', 'đao', 'như', ':', 'tê', 'cay', ',', 'chua cay', ',', 'dâu', 'đo', ',', 'dâu', 'trăng']
Nhiêu khâu vi lai kheo chê biên, nên đa đươc xêp hang đâu trong cac mon ăn ơ trong va ngoai nươc, đươc goi la môi mon môt khac, trăm mon trăm vi	['Nhiêu', 'khâu', 'vi', 'lai', 'kheo', 'chê biên', ',', 'nên', 'đa', 'đươc', 'xêp', 'hang', 'đâu', 'trong', 'cac', 'mon', 'ăn', 'ơ', 'trong', 'va', 'ngoai', 'nươc', ',', 'đươc', 'goi', 'la', 'môi', 'mon', 'môt', 'khac', ',', 'trăm', 'mon', 'trăm', 'vi']
Phương phap nâu cua cac mon ăn Tư Xuyên la kheo dưa vao cac điêu kiên nhiên liêu, khi hâu va thưc khach, vân dung linh hoat tinh hinh cu thê, trong cach nâu ăn co hơn 30 phương phap gôm: xao, ran, chiên, kho, ươp, nôm, muôi	['Phương', 'phap', 'nâu', 'cua', 'cac', 'mon', 'ăn', 'Tư Xuyên la', 'kheo', 'dưa', 'vao', 'cac', 'điêu', 'kiên nhiên', 'liêu', ',', 'khi', 'hâu', 'va', 'thưc', 'khach', ',', 'vân', 'dung', 'linh', 'hoat', 'tinh', 'hinh', 'cu', 'thê', ',', 'trong', 'cach', 'nâu', 'ăn', 'co', 'hơn', '30', 'phương', 'phap', 'gôm', ':', 'xao', ',', 'ran', ',', 'chiên', ',', 'kho', ',', 'ươp', ',', 'nôm', ',', 'muôi']
Theo đa san xuât phat triên va kinh tê phôn vinh, cac mon ăn Tư Xuyên trên cơ sơ vôn co, đa hâp thu sơ trương cua cac mon ăn nam băc, cung như ưu điêm cua cac bưa tiêc quan chưc va nha buôn, hinh thanh đăc điêm mon ăn miên băc nâu theo kiêu Tư Xuyên, mon ăn miên nam mang hương vi Tư Xuyên, nên mơi đươc goi la Thưc tai Trung Quốc, vi tai Tư Xuyên	['Theo', 'đa', 'san', 'xuât', 'phat', 'triên', 'va', 'kinh', 'tê', 'phôn', 'vinh', ',', 'cac', 'mon', 'ăn', 'Tư Xuyên', 'trên', 'cơ', 'sơ', 'vôn', 'co', ',', 'đa', 'hâp', 'thu sơ', 'trương', 'cua', 'cac', 'mon', 'ăn', 'nam', 'băc', ',', 'cung', 'như', 'ưu', 'điêm', 'cua', 'cac', 'bưa', 'tiêc', 'quan', 'chưc', 'va', 'nha', 'buôn', ',', 'hinh', 'thanh', 'đăc', 'điêm', 'mon', 'ăn', 'miên', 'băc', 'nâu', 'theo', 'kiêu', 'Tư Xuyên', ',', 'mon', 'ăn', 'miên', 'nam', 'mang', 'hương', 'vi', 'Tư Xuyên', ',', 'nên', 'mơi', 'đươc', 'goi', 'la', 'Thưc', 'tai', 'Trung Quốc', ',', 'vi', 'tai', 'Tư Xuyên']
Cac mon ăn Tư Xuyên rât coi trong vê thay đôi mui vi, phân biêt ro đâm nhat, năng nhe	['Cac', 'mon', 'ăn', 'Tư Xuyên rât', 'coi', 'trong', 'vê', 'thay', 'đôi', 'mui', 'vi', ',', 'phân', 'biêt', 'ro', 'đâm', 'nhat', ',', 'năng', 'nhe']
Mon ăn Tư Xuyên không thê tach rơi vơi ơt, hoa tiêu va hat tiêu	['Mon', 'ăn', 'Tư Xuyên', 'không', 'thê', 'tach', 'rơi', 'vơi', 'ơt', ',', 'hoa tiêu', 'va', 'hat', 'tiêu']
Co kha nhiêu cach sư dung ơt va rât linh hoat, khi thi dung lam nguyên liêu chinh, khi thi chi dung lam phôi liêu, nhưng phân lơn la dung lam gia vi	['Co', 'kha', 'nhiêu', 'cach', 'sư', 'dung', 'ơt', 'va', 'rât', 'linh', 'hoat', ',', 'khi', 'thi', 'dung', 'lam', 'nguyên', 'liêu', 'chinh', ',', 'khi', 'thi', 'chi', 'dung', 'lam', 'phôi', 'liêu', ',', 'nhưng', 'phân', 'lơn', 'la', 'dung lam', 'gia', 'vi']
Mon ăn Tư Xuyên cung co kha nhiêu kiêu cach đôi mui vi, vưa phu hơp vơi tưng khâu vi cua ngươi ăn, cung thich hơp vơi môi mua khi hâu khac nhau như: mua đông va mua xuân khi hâu ret mươt thi dung vi ơt nhiêu hơn	['Mon', 'ăn', 'Tư Xuyên cung', 'co', 'kha', 'nhiêu', 'kiêu', 'cach', 'đôi', 'mui', 'vi', ',', 'vưa', 'phu', 'hơp', 'vơi', 'tưng', 'khâu', 'vi', 'cua', 'ngươi', 'ăn', ',', 'cung', 'thich', 'hơp', 'vơi', 'môi', 'mua', 'khi', 'hâu', 'khac', 'nhau', 'như', ':', 'mua', 'đông', 'va', 'mua', 'xuân', 'khi', 'hâu', 'ret', 'mươt', 'thi', 'dung', 'vi', 'ơt', 'nhiêu', 'hơn']
Con mua ha va mua thu khi hâu nong bưc thi vi ơt phai giam đi ba phân	['Con', 'mua', 'ha', 'va', 'mua', 'thu', 'khi', 'hâu', 'nong', 'bưc', 'thi', 'vi', 'ơt', 'phai', 'giam', 'đi', 'ba', 'phân']
Môt đăc điêm lơn nhât cua mon ăn Tư Xuyên la kheo điêu chinh mui vi, khâu vi co nông co nhat, trong nhat co nông, nông nhưng không ngây, nhat nhưng không bac	['Môt', 'đăc', 'điêm', 'lơn', 'nhât', 'cua', 'mon', 'ăn', 'Tư Xuyên la', 'kheo', 'điêu', 'chinh', 'mui', 'vi', ',', 'khâu', 'vi', 'co', 'nông', 'co', 'nhat', ',', 'trong', 'nhat', 'co', 'nông', ',', 'nông', 'nhưng', 'không', 'ngây', ',', 'nhat', 'nhưng', 'không', 'bac']
Do đo, mon ăn Tư Xuyên không nhưng lăm vi va nông hâu, ma con co sơ trương vê măt thanh, tươi, đam, nha, khiên ngươi ăn đêu tâm tăc khen ngơi va thât kho quên	['Do', 'đo', ',', 'mon', 'ăn', 'Tư Xuyên', 'không', 'nhưng', 'lăm', 'vi', 'va', 'nông', 'hâu', ',', 'ma', 'con', 'co', 'sơ', 'trương', 'vê', 'măt', 'thanh', ',', 'tươi', ',', 'đam', ',', 'nha', ',', 'khiên', 'ngươi', 'ăn', 'đêu', 'tâm', 'tăc', 'khen', 'ngơi', 'va', 'thât', 'kho', 'quên']
Sau những ngày làm việc mệt nhọc, cuối tuần nhiều đấng mày râu xứ Huế "từ giã vợ con" vác cần đi câu, thả hồn theo sóng nước	['Sau', 'những', 'ngày', 'làm việc', 'mệt nhọc', ',', 'cuối', 'tuần', 'nhiều', 'đấng', 'mày râu', 'xứ', 'Huế', '"', 'từ giã', 'vợ con', '"', 'vác', 'cần', 'đi', 'câu', ',', 'thả', 'hồn', 'theo', 'sóng', 'nước']
Hạ lưu sông Hương, sông Bồ, sông Ngự Hà chảy trong kinh thành hay xuôi về tận đầm phá Tam Giang	['Hạ lưu', 'sông', 'Hương', ',', 'sông', 'Bồ', ',', 'sông', 'Ngự Hà chảy', 'trong', 'kinh thành', 'hay', 'xuôi', 'về', 'tận', 'đầm phá', 'Tam Giang']
“Chiều chiều ông Ngự đi câu/Cái ve, cái chén, cái bầu sau lưng"	['“', 'Chiều chiều', 'ông', 'Ngự', 'đi', 'câu', '/', 'Cái', 've', ',', 'cái', 'chén', ',', 'cái bầu', 'sau', 'lưng', '"']
Có người nói "ông Ngự" trong câu này chính là vua Duy Tân trong câu mái nhì buồn thương của Huế "Chiều chiều trước bến Văn Lâu/Ai ngồi, ai câu, ai sầu, ai thảm?	['Có', 'người', 'nói', '"', 'ông', 'Ngự', '"', 'trong', 'câu', 'này', 'chính', 'là', 'vua', 'Duy Tân', 'trong', 'câu', 'mái nhì', 'buồn', 'thương', 'của', 'Huế', '"', 'Chiều chiều', 'trước', 'bến', 'Văn Lâu', '/', 'Ai', 'ngồi', ',', 'ai', 'câu', ',', 'ai', 'sầu', ',', 'ai', 'thảm', '?']
Lại có người nói "ông Ngự" chính là "ông Lự", một Mệ Huế ở Cửa Trài, ngày xưa nổi tiếng sát ngư, mặc dầu ông chỉ là tay câu tài tử	['Lại', 'có', 'người', 'nói', '"', 'ông', 'Ngự', '"', 'chính', 'là', '"', 'ông', 'Lự', '"', ',', 'một', 'Mệ', 'Huế', 'ở', 'Cửa Trài', ',', 'ngày xưa', 'nổi tiếng', 'sát', 'ngư', ',', 'mặc dầu', 'ông', 'chỉ', 'là', 'tay', 'câu', 'tài tử']
Chứ vua đi câu đầy tâm trạng nước non thế mà ai lại lích kích đem theo cái ve, cái chén làm gì?	['Chứ', 'vua', 'đi', 'câu', 'đầy', 'tâm trạng', 'nước non', 'thế', 'mà', 'ai', 'lại', 'lích kích', 'đem', 'theo', 'cái', 've', ',', 'cái', 'chén', 'làm', 'gì', '?']
Xem ra thì lập luận của ý kiến thứ hai có vẻ đúng hơn	['Xem', 'ra', 'thì', 'lập luận', 'của', 'ý kiến', 'thứ', 'hai', 'có vẻ', 'đúng', 'hơn']
Hậu duệ chính thống của ông Lự tại xóm Cửa Trài sát đồn Mang Cá xưa hiện không rõ là ai nhưng cách đây vài năm, ở đó có mấy tay câu tài tử rất nổi tiếng	['Hậu duệ', 'chính thống', 'của', 'ông', 'Lự', 'tại', 'xóm', 'Cửa Trài', 'sát', 'đồn', 'Mang Cá', 'xưa', 'hiện', 'không', 'rõ', 'là', 'ai', 'nhưng', 'cách', 'đây', 'vài', 'năm', ',', 'ở', 'đó', 'có', 'mấy', 'tay', 'câu', 'tài tử', 'rất', 'nổi tiếng']
Họ chỉ xách cần đi từ ba bốn giờ chiều đến khi mặt trời sắp tắt đã đem cả giỏ cá đầy về	['Họ', 'chỉ', 'xách', 'cần', 'đi', 'từ', 'ba', 'bốn', 'giờ', 'chiều', 'đến', 'khi', 'mặt trời', 'sắp', 'tắt', 'đã', 'đem', 'cả', 'giỏ', 'cá', 'đầy', 'về']
Khu vực của mấy tay câu này ngự trị là Hộ Thành Hào đoạn cầu Cửa Trài ngược lên trên hoặc dưới	['Khu vực', 'của', 'mấy', 'tay', 'câu', 'này', 'ngự trị', 'là', 'Hộ Thành Hào', 'đoạn', 'cầu', 'Cửa Trài', 'ngược', 'lên', 'trên', 'hoặc', 'dưới']
Tương truyền ở đó có cả một vỉa cá thát lát, loại cá các bà nội trợ Huế rất thích bởi lóc thịt nó làm chả cá um măng chua thì các đức ông chồng trăm ông mê mẩn cả trăm	['Tương truyền', 'ở', 'đó', 'có', 'cả', 'một', 'vỉa', 'cá thát lát', ',', 'loại', 'cá', 'các', 'bà', 'nội trợ', 'Huế', 'rất', 'thích', 'bởi', 'lóc', 'thịt', 'nó', 'làm', 'chả cá', 'um', 'măng chua', 'thì', 'các', 'đức ông', 'chồng', 'trăm', 'ông', 'mê mẩn', 'cả', 'trăm']
Cựu trào câu cá thát lát tại đây là anh Dũng	['Cựu trào', 'câu', 'cá thát lát', 'tại', 'đây', 'là', 'anh', 'Dũng']
anh kể có hôm anh câu chỉ trong hai giờ đã được trên ba chục con cá bự hơn bàn tay	['anh', 'kể', 'có', 'hôm', 'anh', 'câu', 'chỉ', 'trong', 'hai', 'giờ', 'đã', 'được', 'trên', 'ba chục', 'con', 'cá', 'bự', 'hơn', 'bàn tay']
Thát lát hay đi ăn theo đàn như cá ngạnh vậy, nên chi đã câu được một con cá thì đừng vội nản nếu chờ lâu không thấy ăn lại	['Thát', 'lát', 'hay', 'đi', 'ăn theo', 'đàn', 'như', 'cá ngạnh', 'vậy', ',', 'nên', 'chi', 'đã', 'câu', 'được', 'một', 'con', 'cá', 'thì', 'đừng', 'vội', 'nản', 'nếu', 'chờ', 'lâu', 'không', 'thấy', 'ăn', 'lại']
Thát lát cũng đa nghi nhưng rất dễ say mồi	['Thát', 'lát', 'cũng', 'đa nghi', 'nhưng', 'rất', 'dễ', 'say', 'mồi']
khi đã say mồi, chúng không để ý đến việc "bè bạn" cứ vơi dần	['khi', 'đã', 'say', 'mồi', ',', 'chúng', 'không', 'để ý', 'đến', 'việc', '"', 'bè bạn', '"', 'cứ', 'vơi', 'dần']
Về sau này, Hộ Thành Hào lấp dần, vỉa cá này cũng vơi đi, anh Dũng và nhóm bạn cũng không còn thời gian như xưa nên đi qua đoạn này đã thấy vắng bóng người câu	['Về', 'sau này', ',', 'Hộ Thành Hào', 'lấp', 'dần', ',', 'vỉa', 'cá', 'này', 'cũng', 'vơi', 'đi', ',', 'anh', 'Dũng', 'và', 'nhóm', 'bạn', 'cũng', 'không', 'còn', 'thời gian', 'như', 'xưa', 'nên', 'đi', 'qua', 'đoạn', 'này', 'đã', 'thấy', 'vắng', 'bóng', 'người', 'câu']
Nhưng ngược lên phía Ngọ Môn, ngay trước cổng Thượng Tứ, thỉnh thoảng ngày đẹp trời cũng thấy có nhiều tay ngư phủ đủ mọi lứa tuổi giăng hàng câu cá rô phi hiện sinh sản rất nhiều	['Nhưng', 'ngược', 'lên', 'phía', 'Ngọ Môn', ',', 'ngay', 'trước', 'cổng', 'Thượng Tứ', ',', 'thỉnh thoảng', 'ngày', 'đẹp', 'trời', 'cũng', 'thấy', 'có', 'nhiều', 'tay', 'ngư phủ', 'đủ', 'mọi', 'lứa', 'tuổi', 'giăng', 'hàng', 'câu', 'cá rô', 'phi', 'hiện sinh sản', 'rất', 'nhiều']
Ông Lưu ở Vỹ Dạ chép miệng nhớ lại cái thời cách đây khoảng hai chục năm	['Ông', 'Lưu', 'ở', 'Vỹ Dạ', 'chép miệng', 'nhớ', 'lại', 'cái', 'thời', 'cách', 'đây', 'khoảng', 'hai', 'chục', 'năm']
Không hiểu sao hồi đó ngoài sông Hương cá rất nhiều, cá nổi đầy sông đến mức đi trên cầu Phú Xuân, cầu Trường Tiền và cả cầu Bạch Hổ nữa cũng thấy cá mương, cá hanh liếc quanh trắng cả mấy cột cầu, chỉ cần thả câu xuống là tha hồ giật cá	['Không', 'hiểu', 'sao', 'hồi', 'đó', 'ngoài', 'sông', 'Hương', 'cá', 'rất', 'nhiều', ',', 'cá', 'nổi', 'đầy', 'sông', 'đến', 'mức', 'đi', 'trên', 'cầu', 'Phú Xuân', ',', 'cầu Trường', 'Tiền', 'và', 'cả', 'cầu', 'Bạch Hổ', 'nữa', 'cũng', 'thấy', 'cá', 'mương', ',', 'cá', 'hanh', 'liếc', 'quanh', 'trắng', 'cả', 'mấy', 'cột', 'cầu', ',', 'chỉ', 'cần', 'thả', 'câu', 'xuống', 'là', 'tha hồ', 'giật', 'cá']
Ngày đó có khi ông câu con cá hanh nặng gần cả ký lô lận, sướng lắm! Sau này, sông Hương đục nước nhiều hơn trong, cá không hiểu vì lý do gì cũng vắng bóng dần, không còn thấy cảnh chiều chiều, đêm đêm trên các cây cầu lộng gió, nhiều tay thả câu bên thành cầu và du khách đã phải dừng chân theo dõi	['Ngày', 'đó', 'có', 'khi', 'ông', 'câu', 'con', 'cá hanh', 'nặng', 'gần', 'cả', 'ký', 'lô', 'lận', ',', 'sướng', 'lắm', '!', 'Sau này', ',', 'sông', 'Hương', 'đục', 'nước', 'nhiều', 'hơn', 'trong', ',', 'cá', 'không', 'hiểu', 'vì', 'lý do', 'gì', 'cũng', 'vắng bóng', 'dần', ',', 'không', 'còn', 'thấy', 'cảnh', 'chiều chiều', ',', 'đêm đêm', 'trên', 'các', 'cây', 'cầu', 'lộng gió', ',', 'nhiều', 'tay', 'thả', 'câu', 'bên', 'thành', 'cầu', 'và', 'du khách', 'đã', 'phải', 'dừng', 'chân', 'theo dõi']
Ngày xưa, ông Lưu có cái cần câu rất đẹp làm bằng cây hóp lỏng già cật ông chặt ở ngôi Mả Cao trên đường về làng Hương Cần cách Huế 10 km	['Ngày xưa', ',', 'ông', 'Lưu', 'có', 'cái', 'cần câu', 'rất', 'đẹp', 'làm', 'bằng', 'cây', 'hóp', 'lỏng', 'già', 'cật', 'ông', 'chặt', 'ở', 'ngôi', 'Mả', 'Cao', 'trên', 'đường', 'về', 'làng', 'Hương', 'Cần', 'cách', 'Huế', '10', 'km']
Trong ký ức của ông, ngôi Mả Cao này xưa là cả một rừng hóp xanh, có một thời gian nghe đồn có băng cướp trú ngụ nên không ai dám chặt phá	['Trong', 'ký ức', 'của', 'ông', ',', 'ngôi', 'Mả', 'Cao', 'này', 'xưa', 'là', 'cả', 'một', 'rừng', 'hóp', 'xanh', ',', 'có', 'một', 'thời gian', 'nghe', 'đồn', 'có', 'băng cướp', 'trú ngụ', 'nên', 'không', 'ai', 'dám', 'chặt', 'phá']
Chỉ riêng ông quá mê câu nên một ngày nọ đâm liều đem rựa chạy xe từ Huế về chặt	['Chỉ', 'riêng', 'ông', 'quá', 'mê', 'câu', 'nên', 'một', 'ngày', 'nọ', 'đâm liều', 'đem', 'rựa', 'chạy', 'xe', 'từ', 'Huế', 'về', 'chặt']
Cướp không thấy đâu mà chỉ thấy cả một rừng hóp để ông tha hồ chọn	['Cướp', 'không', 'thấy', 'đâu', 'mà', 'chỉ', 'thấy', 'cả', 'một', 'rừng', 'hóp', 'để', 'ông', 'tha hồ', 'chọn']
Thế nhưng bây giờ, chiếc cần chỉ còn trong ký ức 50 năm về trước	['Thế', 'nhưng', 'bây giờ', ',', 'chiếc', 'cần', 'chỉ', 'còn', 'trong', 'ký ức', '50', 'năm', 'về', 'trước']
"Bây giờ tụi nó thích câu cũng không biết câu cá gì, có con nào ngoài sông nữa đâu mà câu!" - ông Lưu nói	['"', 'Bây giờ', 'tụi', 'nó', 'thích', 'câu', 'cũng', 'không', 'biết', 'câu', 'cá', 'gì', ',', 'có', 'con', 'nào', 'ngoài', 'sông', 'nữa', 'đâu', 'mà', 'câu', '!', '"', '-', 'ông', 'Lưu', 'nói']
Cũng theo ông Lưu, câu cá bằng cần tre hóp mới thích, chứ sau này lớp trẻ có mấy anh câu cần nhựa, nó không sướng tay tí nào	['Cũng', 'theo', 'ông', 'Lưu', ',', 'câu', 'cá', 'bằng', 'cần', 'tre', 'hóp', 'mới', 'thích', ',', 'chứ', 'sau này', 'lớp', 'trẻ', 'có', 'mấy', 'anh', 'câu', 'cần', 'nhựa', ',', 'nó', 'không', 'sướng tay', 'tí', 'nào']
Cố nhà thơ - nhà báo Thái Ngọc San trong một lần thả câu lúc sinh thời	['Cố', 'nhà thơ', '-', 'nhà báo', 'Thái Ngọc San', 'trong', 'một', 'lần', 'thả', 'câu', 'lúc', 'sinh thời']
Thế mà cứ mỗi sáng thứ bảy, chủ nhật, lại thấy vài chục xe máy cứ hai anh một xe, thỉnh thoảng có mấy nàng cũng xách mồi đi theo xem chàng câu cá	['Thế mà', 'cứ', 'mỗi', 'sáng', 'thứ bảy', ',', 'chủ nhật', ',', 'lại', 'thấy', 'vài', 'chục', 'xe máy', 'cứ', 'hai', 'anh', 'một', 'xe', ',', 'thỉnh thoảng', 'có', 'mấy', 'nàng', 'cũng', 'xách', 'mồi', 'đi', 'theo', 'xem', 'chàng', 'câu', 'cá']
Địa điểm mà các anh chị hay đến là khúc cong sông Bồ đoạn chảy qua làng La Vân Thượng thuộc xã Quảng Thọ (huyện Quảng Điền), quê hương Đại tướng Nguyễn Chí Thanh, cách Huế khoảng 13 km	['Địa điểm', 'mà', 'các', 'anh chị', 'hay', 'đến', 'là', 'khúc', 'cong', 'sông', 'Bồ đoạn', 'chảy', 'qua', 'làng', 'La Vân Thượng thuộc', 'xã', 'Quảng Thọ', '(', 'huyện', 'Quảng Điền', ')', ',', 'quê hương', 'Đại tướng', 'Nguyễn Chí Thanh', ',', 'cách', 'Huế', 'khoảng', '13', 'km']
Tương truyền ngày xưa vị tướng tài hoa này cũng là tay sát ngư, và đi câu cũng là hình thức truyền đạt thông tin làm cách mạng với các đồng chí của mình	['Tương truyền', 'ngày xưa', 'vị', 'tướng', 'tài hoa', 'này', 'cũng', 'là', 'tay', 'sát', 'ngư', ',', 'và', 'đi', 'câu', 'cũng', 'là', 'hình thức', 'truyền đạt', 'thông tin', 'làm', 'cách mạng', 'với', 'các', 'đồng chí', 'của', 'mình']
Khúc sông này người dân nuôi cá lồng rất nhiều nên cá ngoài sông rất hay tụ tập quanh các lồng để "ăn ké" thức ăn	['Khúc', 'sông', 'này', 'người', 'dân', 'nuôi', 'cá lồng', 'rất', 'nhiều', 'nên', 'cá', 'ngoài', 'sông', 'rất', 'hay', 'tụ tập', 'quanh', 'các', 'lồng', 'để', '"', 'ăn ké', '"', 'thức ăn']
Các tay câu chỉ cần thả câu gần lồng và chờ đợi	['Các', 'tay', 'câu', 'chỉ', 'cần', 'thả', 'câu', 'gần', 'lồng', 'và', 'chờ đợi']
Cá ở quanh các lồng này thường là cá mè, cá chép, cá trắm và ăn khá tạp	['Cá', 'ở', 'quanh', 'các', 'lồng', 'này', 'thường', 'là', 'cá', 'mè', ',', 'cá', 'chép', ',', 'cá trắm', 'và', 'ăn', 'khá', 'tạp']
Mồi chỉ cần một miếng bột mì ngào với tép, thậm chí một hạt bắp non là đủ	['Mồi', 'chỉ', 'cần', 'một', 'miếng', 'bột', 'mì', 'ngào', 'với', 'tép', ',', 'thậm chí', 'một', 'hạt', 'bắp', 'non', 'là', 'đủ']
Nếu muốn câu cá trê thì vào Bàu Gian ở gần đó	['Nếu', 'muốn', 'câu', 'cá trê', 'thì', 'vào', 'Bàu Gian', 'ở', 'gần', 'đó']
Bàu Gian là cái đầm lầy rộng và khá sâu, sở dĩ có tên như vậy bởi ngày xưa tương truyền Thần Khai canh Phe Kiền làng Hương Cần (Hương Trà) nổi tiếng quýt ngọt ăn gian phần đất của làng La Vân mà có	['Bàu Gian', 'là', 'cái', 'đầm', 'lầy', 'rộng', 'và', 'khá', 'sâu', ',', 'sở dĩ', 'có', 'tên', 'như', 'vậy', 'bởi', 'ngày xưa', 'tương truyền Thần', 'Khai canh', 'Phe', 'Kiền', 'làng', 'Hương', 'Cần', '(', 'Hương Trà', ')', 'nổi tiếng', 'quýt', 'ngọt', 'ăn gian', 'phần', 'đất', 'của', 'làng', 'La Vân', 'mà', 'có']
Bàu này có con lạch thông ra sông Bồ nên cá đồng thường ngược nước mùa mưa chạy vào, nhiều nhất là cá trê	['Bàu', 'này', 'có', 'con', 'lạch', 'thông', 'ra', 'sông', 'Bồ', 'nên', 'cá đồng', 'thường', 'ngược', 'nước', 'mùa', 'mưa', 'chạy', 'vào', ',', 'nhiều', 'nhất', 'là', 'cá trê']
Loài cá trê khá lạ, nó nghe tiếng nước dộng và đám bùn khuấy lên là tụ tập đến tìm mồi	['Loài', 'cá trê', 'khá', 'lạ', ',', 'nó', 'nghe', 'tiếng', 'nước', 'dộng', 'và', 'đám', 'bùn', 'khuấy', 'lên', 'là', 'tụ tập', 'đến', 'tìm', 'mồi']
Ngày xưa khi người ta nuôi trâu nhiều, thường trẻ chăn trâu thả trâu ra ăn ở đây, chỉ cần trâu lội qua là mấy tay câu thả phao xuống liền	['Ngày xưa', 'khi', 'người ta', 'nuôi', 'trâu', 'nhiều', ',', 'thường', 'trẻ', 'chăn', 'trâu', 'thả', 'trâu', 'ra', 'ăn', 'ở', 'đây', ',', 'chỉ', 'cần', 'trâu', 'lội', 'qua', 'là', 'mấy', 'tay', 'câu', 'thả', 'phao', 'xuống', 'liền']
Nay thì đồng cỏ vắng trâu, đi câu phải đem theo cái dậm để dậm, dậm xong thì thả phao xuống ngay chỗ đó, có thể dậm một lần nhiều chỗ và thả nhiều cần một lúc vì cá trê ăn khá tạp	['Nay', 'thì', 'đồng cỏ', 'vắng', 'trâu', ',', 'đi', 'câu', 'phải', 'đem', 'theo', 'cái', 'dậm', 'để', 'dậm', ',', 'dậm', 'xong', 'thì', 'thả', 'phao', 'xuống', 'ngay', 'chỗ', 'đó', ',', 'có thể', 'dậm', 'một', 'lần', 'nhiều', 'chỗ', 'và', 'thả', 'nhiều', 'cần', 'một', 'lúc', 'vì', 'cá trê', 'ăn', 'khá', 'tạp']
Cá trê đồng khi ăn, ngậm mồi xong thì kéo mồi đi giật lùi nên phải giật cần câu cùng chiều với hướng phao chạy mới mong lưỡi câu móc vào mép cá, còn nếu giật ngược chiều, lưỡi câu sẽ bị vuột	['Cá trê', 'đồng', 'khi', 'ăn', ',', 'ngậm', 'mồi', 'xong', 'thì', 'kéo', 'mồi', 'đi', 'giật lùi', 'nên', 'phải', 'giật', 'cần câu', 'cùng', 'chiều', 'với', 'hướng', 'phao', 'chạy', 'mới', 'mong', 'lưỡi', 'câu', 'móc', 'vào', 'mép', 'cá', ',', 'còn', 'nếu', 'giật', 'ngược', 'chiều', ',', 'lưỡi câu', 'sẽ', 'bị', 'vuột']
các loại cá này ăn rất "kín", răng chúng sắc và thường đưa mồi lên rồi mới ăn nên nhiều khi phao không động đậy mà cá đã chén sạch mồi, mặc dầu mồi là những con trùng đỏ bám rất sát lưỡi câu	['các', 'loại', 'cá', 'này', 'ăn', 'rất', '"', 'kín', '"', ',', 'răng', 'chúng', 'sắc', 'và', 'thường', 'đưa', 'mồi', 'lên', 'rồi', 'mới', 'ăn', 'nên', 'nhiều', 'khi', 'phao', 'không', 'động đậy', 'mà', 'cá', 'đã', 'chén', 'sạch', 'mồi', ',', 'mặc dầu', 'mồi', 'là', 'những', 'con', 'trùng', 'đỏ', 'bám', 'rất', 'sát', 'lưỡi câu']
Đi câu cá diếc, cá chép thì ngược lên phía trên khoảng 3 km nữa, qua cầu Phước Yên đến quê hương của ông tổ nghề nhiếp ảnh Việt Nam - nhà thơ Đặng Huy Trứ ở làng Thành Lương, xã Hương Xuân (Hương Trà)	['Đi', 'câu', 'cá diếc', ',', 'cá chép', 'thì', 'ngược', 'lên', 'phía', 'trên', 'khoảng', '3', 'km', 'nữa', ',', 'qua', 'cầu', 'Phước Yên', 'đến', 'quê hương', 'của', 'ông', 'tổ', 'nghề', 'nhiếp ảnh', 'Việt Nam', '-', 'nhà thơ', 'Đặng Huy Trứ', 'ở', 'làng', 'Thành Lương', ',', 'xã', 'Hương Xuân', '(', 'Hương Trà', ')']
Chảy qua làng có một con hói dẫn nước từ sông Bồ vào, không hiểu hơi bùn con hói thế nào mà cá chép, cá diếc sinh sống rất nhiều	['Chảy', 'qua', 'làng', 'có', 'một', 'con', 'hói', 'dẫn', 'nước', 'từ', 'sông', 'Bồ', 'vào', ',', 'không', 'hiểu', 'hơi', 'bùn', 'con', 'hói', 'thế nào', 'mà', 'cá chép', ',', 'cá diếc', 'sinh sống', 'rất', 'nhiều']
nhiều gia đình ở đây cứ đi làm đồng về xách cần ra câu chừng nửa giờ là đã có bát canh chua đầy cá, khỏi phải đi chợ	['nhiều', 'gia đình', 'ở', 'đây', 'cứ', 'đi', 'làm đồng', 'về', 'xách', 'cần', 'ra', 'câu', 'chừng', 'nửa', 'giờ', 'là', 'đã', 'có', 'bát', 'canh', 'chua', 'đầy', 'cá', ',', 'khỏi', 'phải', 'đi', 'chợ']
Ở con hói này, thỉnh thoảng đi câu cũng gặp cá ngạnh hay có nơi còn gọi cá ngạnh nguồn	['Ở', 'con', 'hói', 'này', ',', 'thỉnh thoảng', 'đi', 'câu', 'cũng', 'gặp', 'cá ngạnh', 'hay', 'có', 'nơi', 'còn', 'gọi', 'cá ngạnh', 'nguồn']
Gặp loài cá này thì giật mỏi tay phải biết vì nó rất tham ăn và đi theo đàn, chỉ có điều gỡ nó ra khỏi lưỡi câu cũng hơi rắc rối vì ngạnh nó đâm đau nhức không kém gì ngạnh cá trê	['Gặp', 'loài', 'cá', 'này', 'thì', 'giật', 'mỏi', 'tay', 'phải', 'biết', 'vì', 'nó', 'rất', 'tham', 'ăn', 'và', 'đi', 'theo', 'đàn', ',', 'chỉ', 'có', 'điều', 'gỡ', 'nó', 'ra', 'khỏi', 'lưỡi câu', 'cũng', 'hơi', 'rắc rối', 'vì', 'ngạnh', 'nó', 'đâm', 'đau nhức', 'không', 'kém', 'gì', 'ngạnh', 'cá trê']
Dân đi câu cá đồng thường thích câu cá rô nhất	['Dân', 'đi', 'câu', 'cá đồng', 'thường', 'thích', 'câu', 'cá rô', 'nhất']
loài cá này ngậm mồi xong là rút phao rất sâu, chỉ cần giật cần nhẹ một cái là đã thấy chú cá tung tăng đầu cần rồi, rất sướng tay, sướng mắt	['loài', 'cá', 'này', 'ngậm', 'mồi', 'xong', 'là', 'rút', 'phao', 'rất', 'sâu', ',', 'chỉ', 'cần', 'giật', 'cần', 'nhẹ', 'một', 'cái', 'là', 'đã', 'thấy', 'chú', 'cá', 'tung tăng', 'đầu', 'cần', 'rồi', ',', 'rất', 'sướng tay', ',', 'sướng mắt']
Còn ở đầm Phong Chương thì chỉ dành cho các tay câu cá tràu (cá lóc)	['Còn', 'ở', 'đầm', 'Phong Chương', 'thì', 'chỉ', 'dành', 'cho', 'các', 'tay', 'câu', 'cá tràu', '(', 'cá lóc', ')']
Trên tuyến đường từ quốc lộ 1A đoạn qua những quán cơm Phò Trạch nổi tiếng ở Phong Điền, có một con đường chạy qua những trảng cát rộng mênh mông nối về Phong Chương	['Trên', 'tuyến', 'đường', 'từ', 'quốc lộ', '1A', 'đoạn', 'qua', 'những', 'quán', 'cơm', 'Phò Trạch', 'nổi tiếng', 'ở', 'Phong Điền', ',', 'có', 'một', 'con', 'đường', 'chạy', 'qua', 'những', 'trảng', 'cát', 'rộng', 'mênh mông', 'nối', 'về', 'Phong', 'Chương']
Thế nhưng, đi khoảng vài ba cây số đã thấy dưới chân những trảng cát này nhiều cái đầm xăm xắp nước	['Thế', 'nhưng', ',', 'đi', 'khoảng', 'vài ba', 'cây số', 'đã', 'thấy', 'dưới', 'chân', 'những', 'trảng', 'cát', 'này', 'nhiều', 'cái', 'đầm', 'xăm xắp', 'nước']
Có những ngày, dân câu từ Huế chạy xe ra đến đây để kiếm một chú tràu bông rồi về	['Có', 'những', 'ngày', ',', 'dân', 'câu', 'từ', 'Huế', 'chạy', 'xe', 'ra', 'đến', 'đây', 'để', 'kiếm', 'một', 'chú', 'tràu', 'bông', 'rồi', 'về']
Không hiểu sao cá tràu bông lại quần cư ở những đầm lầy này? Cá tràu bông ở đây rất ngon, có lẽ do nguồn nước ngọt được lọc qua những trảng cát và thức ăn cho cá ở đây phần lớn là các loài côn trùng, sâu bọ, ếch nhái	['Không', 'hiểu', 'sao', 'cá tràu', 'bông', 'lại', 'quần cư', 'ở', 'những', 'đầm', 'lầy', 'này', '?', 'Cá tràu', 'bông', 'ở', 'đây', 'rất', 'ngon', ',', 'có lẽ', 'do', 'nguồn', 'nước ngọt', 'được', 'lọc', 'qua', 'những', 'trảng', 'cát', 'và', 'thức ăn', 'cho', 'cá', 'ở', 'đây', 'phần lớn', 'là', 'các', 'loài', 'côn trùng', ',', 'sâu bọ', ',', 'ếch nhái']
Dân câu còn đến ven phá Tam Giang, nhiều nhất là ở các hồ tôm ở Phú Tân, Thuận An, Phú Thuận	['Dân', 'câu', 'còn', 'đến', 'ven', 'phá', 'Tam Giang', ',', 'nhiều', 'nhất', 'là', 'ở', 'các', 'hồ', 'tôm', 'ở', 'Phú Tân', ',', 'Thuận An', ',', 'Phú Thuận']
Các hồ tôm sau khi phơi xả nước vào thế nào cũng có cá đi theo, sau dần cá lớn ăn tranh thức ăn của tôm, thậm chí ăn thịt cả tôm nữa nên chủ hồ tôm rất ghét	['Các', 'hồ', 'tôm', 'sau', 'khi', 'phơi', 'xả', 'nước', 'vào', 'thế nào', 'cũng', 'có', 'cá', 'đi', 'theo', ',', 'sau', 'dần', 'cá', 'lớn', 'ăn', 'tranh', 'thức ăn', 'của', 'tôm', ',', 'thậm chí', 'ăn', 'thịt', 'cả', 'tôm', 'nữa', 'nên', 'chủ', 'hồ', 'tôm', 'rất', 'ghét']
Thường câu tại đây là câu cá dìa, cá hồng, cá ong hương	['Thường', 'câu', 'tại', 'đây', 'là', 'câu', 'cá', 'dìa', ',', 'cá', 'hồng', ',', 'cá', 'ong', 'hương']
toàn các loài cá đặc sản nổi tiếng của phá Tam Giang	['toàn', 'các', 'loài', 'cá', 'đặc sản', 'nổi tiếng', 'của', 'phá', 'Tam Giang']
Ở Huế có hai người đi câu cá hồ rất nổi tiếng là đôi bạn câu cùng họ Thái của cố nhà thơ, nhà báo Thái Ngọc San (Báo Thanh Niên) và anh Thái Nguyên Hạnh (em trai TS Thái Kim Lan)	['Ở', 'Huế', 'có', 'hai', 'người', 'đi', 'câu', 'cá', 'hồ', 'rất', 'nổi tiếng', 'là', 'đôi', 'bạn', 'câu', 'cùng', 'họ', 'Thái', 'của', 'cố', 'nhà thơ', ',', 'nhà báo', 'Thái Ngọc San', '(', 'Báo', 'Thanh Niên', ')', 'và', 'anh', 'Thái Nguyên', 'Hạnh', '(', 'em trai', 'TS', 'Thái', 'Kim Lan', ')']
Những năm sau này, vào cuối tuần, anh Thái Ngọc San thường đi câu suốt ngày, có hôm đem về cả đùm cá lớn, chia cho anh em bạn bè cùng ăn	['Những', 'năm', 'sau này', ',', 'vào', 'cuối', 'tuần', ',', 'anh', 'Thái Ngọc San', 'thường', 'đi', 'câu', 'suốt', 'ngày', ',', 'có', 'hôm', 'đem', 'về', 'cả', 'đùm', 'cá', 'lớn', ',', 'chia', 'cho', 'anh em', 'bạn bè', 'cùng', 'ăn']
Cũng nhiều khi anh San tự tay nấu cháo cá do anh câu để đãi, cá ngon và cháo ngọt cùng với cái tính tỉ mẩn chăm lo cho bạn bè và nụ cười hiền của anh, ăn bát cháo xong không dễ quên trong đời	['Cũng', 'nhiều', 'khi', 'anh', 'San', 'tự', 'tay', 'nấu', 'cháo', 'cá', 'do', 'anh', 'câu', 'để', 'đãi', ',', 'cá', 'ngon', 'và', 'cháo', 'ngọt', 'cùng', 'với', 'cái', 'tính', 'tỉ mẩn', 'chăm lo', 'cho', 'bạn bè', 'và', 'nụ', 'cười', 'hiền', 'của', 'anh', ',', 'ăn', 'bát', 'cháo', 'xong', 'không', 'dễ', 'quên', 'trong', 'đời']
Cũng có nhiều anh lười lại thích đi câu ở các hồ câu thư giãn	['Cũng', 'có', 'nhiều', 'anh', 'lười', 'lại', 'thích', 'đi', 'câu', 'ở', 'các', 'hồ', 'câu', 'thư giãn']
Huế có hai hồ câu thư giãn nổi tiếng là hồ Thư Giãn ở xã Phú Mậu, cách đập ngăn mặn Thảo Long không xa; hồ thứ hai là hồ câu ở Ngư Tiều Phủ đoạn đường lên lăng Khải Định, cách cửa đồi Thiên An chừng hơn cây số	['Huế', 'có', 'hai', 'hồ', 'câu', 'thư giãn', 'nổi tiếng', 'là', 'hồ', 'Thư Giãn', 'ở', 'xã', 'Phú Mậu', ',', 'cách', 'đập', 'ngăn mặn', 'Thảo Long', 'không', 'xa', ';', 'hồ', 'thứ', 'hai', 'là', 'hồ', 'câu', 'ở', 'Ngư Tiều', 'Phủ', 'đoạn', 'đường', 'lên', 'lăng', 'Khải Định', ',', 'cách', 'cửa', 'đồi', 'Thiên An', 'chừng', 'hơn', 'cây số']
Khách vào câu ở các hồ này có quyền câu ăn tại chỗ hoặc bới mang về, tùy hứng	['Khách', 'vào', 'câu', 'ở', 'các', 'hồ', 'này', 'có', 'quyền', 'câu', 'ăn', 'tại chỗ', 'hoặc', 'bới', 'mang', 'về', ',', 'tùy', 'hứng']
có người câu chừng nửa giờ đã được hơn chục cá, nhưng cá thường là cá trê lai, ăn rất tạp nhưng thịt dở	['có', 'người', 'câu', 'chừng', 'nửa', 'giờ', 'đã', 'được', 'hơn', 'chục', 'cá', ',', 'nhưng', 'cá', 'thường', 'là', 'cá trê lai', ',', 'ăn', 'rất', 'tạp', 'nhưng', 'thịt', 'dở']
Đi câu cá ở các hồ này, thường các anh chị hay rủ nhau đi để mà còn "câu" nhau	['Đi', 'câu', 'cá', 'ở', 'các', 'hồ', 'này', ',', 'thường', 'các', 'anh chị', 'hay', 'rủ', 'nhau', 'đi', 'để', 'mà', 'còn', '"', 'câu', '"', 'nhau']
Có vài anh bạn sáng hôm sau kể chuyện đi câu cá hồ như một công trạng: "Hôm qua vừa câu được con cá bốn chục cân" rồi cười	['Có', 'vài', 'anh', 'bạn', 'sáng', 'hôm', 'sau', 'kể', 'chuyện', 'đi', 'câu', 'cá', 'hồ', 'như', 'một', 'công trạng', ':', '"', 'Hôm qua', 'vừa', 'câu', 'được', 'con', 'cá', 'bốn', 'chục', 'cân', '"', 'rồi', 'cười']
Người viết bài này đã vài lần đi câu ở các hồ này, song thấy không sướng bằng cái thú đi câu ngoài hương đồng cỏ nội	['Người', 'viết', 'bài', 'này', 'đã', 'vài', 'lần', 'đi', 'câu', 'ở', 'các', 'hồ', 'này', ',', 'song', 'thấy', 'không', 'sướng', 'bằng', 'cái', 'thú', 'đi', 'câu', 'ngoài', 'hương', 'đồng cỏ', 'nội']
Nhiều khi cùng đi với bạn bè uống vài chai bia hay nhấp tí rượu tại đó, nhìn bạn bè câu mà nhớ đến những câu chuyện hiệp khách giang hồ ngày xưa, ôm cần ngẫm chuyện thời thế	['Nhiều', 'khi', 'cùng', 'đi', 'với', 'bạn bè', 'uống', 'vài', 'chai', 'bia', 'hay', 'nhấp', 'tí', 'rượu', 'tại', 'đó', ',', 'nhìn', 'bạn bè', 'câu', 'mà', 'nhớ', 'đến', 'những', 'câu chuyện', 'hiệp khách', 'giang hồ', 'ngày xưa', ',', 'ôm', 'cần', 'ngẫm', 'chuyện', 'thời thế']
Là đệ tử trung thành của game online, khi đi công tác, anh Xuân nhờ vợ chơi thay và giới thiệu bạn đồng môn ruột kèm cặp giúp	['Là', 'đệ tử', 'trung thành', 'của', 'game', 'online', ',', 'khi', 'đi', 'công tác', ',', 'anh', 'Xuân', 'nhờ', 'vợ', 'chơi', 'thay', 'và', 'giới thiệu', 'bạn', 'đồng môn', 'ruột', 'kèm cặp', 'giúp']
Không hiểu được dẫn dắt thế nào mà vợ anh say game rồi say cả người đồng hành chưa một lần gặp mặt, định bỏ tất cả để ra Hà Nội gặp nhau	['Không', 'hiểu', 'được', 'dẫn dắt', 'thế nào', 'mà', 'vợ', 'anh', 'say', 'game', 'rồi', 'say', 'cả', 'người', 'đồng hành', 'chưa', 'một', 'lần', 'gặp mặt', ',', 'định', 'bỏ', 'tất cả', 'để', 'ra', 'Hà Nội', 'gặp', 'nhau']
Việc giao lưu qua net có thể giúp cân bằng đời sống tâm lý, đáp ứng phần nào nhu cầu thể hiện bản thân	['Việc', 'giao lưu', 'qua', 'net', 'có thể', 'giúp', 'cân bằng', 'đời sống', 'tâm lý', ',', 'đáp ứng', 'phần nào', 'nhu cầu', 'thể hiện', 'bản thân']
Sau khi lên mạng, nhiều người cảm thấy rất ép-phê", vui thích vì đã tâm tình, kết bạn, giải stress một cách thoải mái	['Sau', 'khi', 'lên', 'mạng', ',', 'nhiều', 'người', 'cảm thấy', 'rất', 'ép', '-', 'phê', '"', ',', 'vui thích', 'vì', 'đã', 'tâm tình', ',', 'kết bạn', ',', 'giải', 'stress', 'một cách', 'thoải mái']
Nhờ ông tơ net, đã có không ít người tìm được một nửa rất ưng ý và đi đến hôn nhân	['Nhờ', 'ông', 'tơ', 'net', ',', 'đã', 'có', 'không', 'ít', 'người', 'tìm', 'được', 'một nửa', 'rất', 'ưng ý', 'và', 'đi', 'đến', 'hôn nhân']
Ngày 11/3 vừa qua đã là ngày cưới hạnh phúc của một cô gái Nha Trang với người ấy quen qua mạng	['Ngày', '11/3', 'vừa qua', 'đã', 'là', 'ngày', 'cưới', 'hạnh phúc', 'của', 'một', 'cô', 'gái', 'Nha Trang', 'với', 'người', 'ấy', 'quen', 'qua', 'mạng']
Người phụ nữ này sống khá khép kín, tình nguyện lên vùng Khánh Sơn dạy học	['Người', 'phụ nữ', 'này', 'sống', 'khá', 'khép kín', ',', 'tình nguyện', 'lên', 'vùng', 'Khánh Sơn', 'dạy học']
Cô đã vượt qua khó khăn của cuộc sống và những định kiến từ sự chia ly của cha mẹ để cùng người ấy đưa tình yêu trên mạng của họ đến đích	['Cô', 'đã', 'vượt', 'qua', 'khó khăn', 'của', 'cuộc sống', 'và', 'những', 'định kiến', 'từ', 'sự', 'chia ly', 'của', 'cha mẹ', 'để', 'cùng', 'người', 'ấy', 'đưa', 'tình yêu', 'trên', 'mạng', 'của', 'họ', 'đến', 'đích']
Tuy nhiên, người trên mạng thường không đúng như người thực nên nguy cơ gặp tình ảo thực dụng cũng dễ xảy ra	['Tuy nhiên', ',', 'người', 'trên', 'mạng', 'thường', 'không', 'đúng', 'như', 'người', 'thực', 'nên', 'nguy cơ', 'gặp', 'tình', 'ảo', 'thực dụng', 'cũng', 'dễ', 'xảy', 'ra']
Sau 2 tháng chat với chàng sinh viên ở Vũng Tàu, một nữ nhân viên văn phòng được rủ ra Vũng Tàu dự tiệc sinh nhật	['Sau', '2', 'tháng', 'chat', 'với', 'chàng', 'sinh viên', 'ở', 'Vũng Tàu', ',', 'một', 'nữ', 'nhân viên', 'văn phòng', 'được', 'rủ', 'ra', 'Vũng Tàu', 'dự', 'tiệc', 'sinh nhật']
Vì tiệc muộn, cô phải nghỉ lại và sau một đêm thì	['Vì', 'tiệc', 'muộn', ',', 'cô', 'phải', 'nghỉ', 'lại', 'và', 'sau', 'một', 'đêm', 'thì']
Nhân chuyện này, một chuyên viên tư vấn thổ lộ rằng khi lên mạng, nếu không có một bộ lọc thì cũng khó phân biệt tình thật và tình giả	['Nhân', 'chuyện', 'này', ',', 'một', 'chuyên viên', 'tư vấn', 'thổ lộ', 'rằng', 'khi', 'lên', 'mạng', ',', 'nếu', 'không', 'có', 'một', 'bộ', 'lọc', 'thì', 'cũng', 'khó', 'phân biệt', 'tình thật', 'và', 'tình', 'giả']
Ngay cả người đã lập gia đình cũng vướng lưới, có khi phải trả giá bằng hạnh phúc của mình	['Ngay', 'cả', 'người', 'đã', 'lập', 'gia đình', 'cũng', 'vướng', 'lưới', ',', 'có khi', 'phải', 'trả giá', 'bằng', 'hạnh phúc', 'của', 'mình']
Là một người nghiện game online, khi đi công tác xa, anh nhờ vợ chơi thay và giới thiệu bạn chơi trên mạng kèm cặp giúp	['Là', 'một', 'người', 'nghiện', 'game', 'online', ',', 'khi', 'đi', 'công tác', 'xa', ',', 'anh', 'nhờ', 'vợ', 'chơi', 'thay', 'và', 'giới thiệu', 'bạn', 'chơi', 'trên', 'mạng', 'kèm cặp', 'giúp']
Vợ anh sau đó đâm mê anh bạn đồng hành chưa một lần gặp mặt, định bỏ tất cả để ra Hà Nội với người ảo trên mạng	['Vợ', 'anh', 'sau', 'đó', 'đâm', 'mê', 'anh', 'bạn', 'đồng hành', 'chưa', 'một', 'lần', 'gặp mặt', ',', 'định', 'bỏ', 'tất cả', 'để', 'ra', 'Hà Nội', 'với', 'người', 'ảo', 'trên', 'mạng']
Anh Xuân chỉ còn biết đấm ngực than trời rằng chỉ vì mình mới ra cớ sự	['Anh', 'Xuân', 'chỉ', 'còn', 'biết', 'đấm ngực', 'than', 'trời', 'rằng', 'chỉ', 'vì', 'mình', 'mới', 'ra', 'cớ sự']
Người trên mạng thường "có vẻ" sâu sắc, bản lĩnh, khôn ngoan và đáng yêu hơn	['Người', 'trên', 'mạng', 'thường', '"', 'có vẻ', '"', 'sâu sắc', ',', 'bản lĩnh', ',', 'khôn ngoan', 'và', 'đáng', 'yêu', 'hơn']
Vì vậy, nhiều người cứ đắm chìm với net và cũng tự bốc mình thành một người rất hoàn hảo cho tương xứng	['Vì vậy', ',', 'nhiều', 'người', 'cứ', 'đắm', 'chìm', 'với', 'net', 'và', 'cũng', 'tự', 'bốc', 'mình', 'thành', 'một', 'người', 'rất', 'hoàn hảo', 'cho', 'tương xứng']
Chồng của chị Uyên mỗi tối làm việc trên vi tính 3-4 giờ liền	['Chồng', 'của', 'chị', 'Uyên', 'mỗi', 'tối', 'làm việc', 'trên', 'vi tính', '3-4', 'giờ', 'liền']
Khi cơ quan yêu cầu cập nhật kỹ năng thực hành vi tính, chị Uyên vào máy mới phát hiện anh có một cuộc tình	['Khi', 'cơ quan', 'yêu cầu', 'cập nhật', 'kỹ năng', 'thực hành vi', 'tính', ',', 'chị', 'Uyên', 'vào', 'máy', 'mới', 'phát hiện', 'anh', 'có', 'một', 'cuộc', 'tình']
Theo lời chuyên viên tư vấn, chị không vội làm ầm ĩ và người chồng vẫn mải mê làm việc với máy tính	['Theo', 'lời', 'chuyên viên', 'tư vấn', ',', 'chị', 'không', 'vội', 'làm', 'ầm ĩ', 'và', 'người', 'chồng', 'vẫn', 'mải mê', 'làm việc', 'với', 'máy tính']
Một tối khuya, chị vừa khuấy cà phê mời chồng vừa nhẹ nhàng bảo: Chúng mình cùng nói chuyện nhé! Anh vội vàng phân bua và mở hết chat ra cho chị xem	['Một', 'tối', 'khuya', ',', 'chị', 'vừa', 'khuấy', 'cà phê', 'mời', 'chồng', 'vừa', 'nhẹ nhàng', 'bảo', ':', 'Chúng mình', 'cùng', 'nói chuyện', 'nhé', '!', 'Anh', 'vội vàng', 'phân bua', 'và', 'mở', 'hết', 'chat', 'ra', 'cho', 'chị', 'xem']
Hóa ra, khi thì anh chỉ mới đôi mươi, khi thì đã nửa đời người, chẳng có chân dùng nào thật	['Hóa ra', ',', 'khi', 'thì', 'anh', 'chỉ', 'mới', 'đôi mươi', ',', 'khi', 'thì', 'đã', 'nửa', 'đời', 'người', ',', 'chẳng', 'có', 'chân', 'dùng', 'nào', 'thật']
Anh còn "tự họa" mình là một đấng mày râu tuyệt vời!	['Anh', 'còn', '"', 'tự', 'họa', '"', 'mình', 'là', 'một', 'đấng', 'mày râu', 'tuyệt vời', '!']
Một câu chuyện khác: Chị Trang bán buôn rất giỏi, có đến mấy cửa hàng; chồng làm nghề nhiếp ảnh, quay video	['Một', 'câu chuyện', 'khác', ':', 'Chị', 'Trang', 'bán buôn', 'rất', 'giỏi', ',', 'có', 'đến', 'mấy', 'cửa hàng', ';', 'chồng', 'làm', 'nghề', 'nhiếp ảnh', ',', 'quay', 'video']
Ngại chồng vất vả, chị đề nghị anh ở nhà phụ giúp	['Ngại', 'chồng', 'vất vả', ',', 'chị', 'đề nghị', 'anh', 'ở', 'nhà', 'phụ giúp']
Khá rảnh rỗi nên anh thường đi chơi đây đó rồi vào mạng	['Khá', 'rảnh rỗi', 'nên', 'anh', 'thường', 'đi', 'chơi', 'đây đó', 'rồi', 'vào', 'mạng']
Hai con đã lớn nên chị cũng học sử dụng vi tính	['Hai', 'con', 'đã', 'lớn', 'nên', 'chị', 'cũng', 'học', 'sử dụng', 'vi tính']
Tình cờ biết nick của chồng, chị bí mật chat và cứ khen hết lời để rồi tá hỏa: Chồng chị tự nhận là người rất giỏi giang, một tay làm nên cửa nhà, tài sản ước hơn 5 tỷ đồng (gấp 5 lần thực tế!)	['Tình cờ', 'biết', 'nick', 'của', 'chồng', ',', 'chị', 'bí mật', 'chat', 'và', 'cứ', 'khen', 'hết', 'lời', 'để', 'rồi', 'tá hỏa', ':', 'Chồng', 'chị', 'tự', 'nhận', 'là', 'người', 'rất', 'giỏi giang', ',', 'một', 'tay', 'làm nên', 'cửa', 'nhà', ',', 'tài sản', 'ước', 'hơn', '5', 'tỷ', 'đồng', '(', 'gấp', '5', 'lần', 'thực tế', '!', ')']
Chưa hết, anh rất cô đơn vì có bà vợ xấu xí, hung dữ lại mắc bệnh hiểm nghèo, cần có một bạn nữ dịu dàng, biết chia sẻ, cảm thông	['Chưa', 'hết', ',', 'anh', 'rất', 'cô đơn', 'vì', 'có', 'bà', 'vợ', 'xấu xí', ',', 'hung dữ', 'lại', 'mắc', 'bệnh', 'hiểm nghèo', ',', 'cần', 'có', 'một', 'bạn', 'nữ', 'dịu dàng', ',', 'biết', 'chia sẻ', ',', 'cảm thông']
Còn chị Yến, nhân viên một trường mầm non, sau thời gian yêu qua net thấy không thể thiếu nhau, chị và người ấy hẹn gặp ở một cây xăng	['Còn', 'chị', 'Yến', ',', 'nhân viên', 'một', 'trường', 'mầm non', ',', 'sau', 'thời gian', 'yêu', 'qua', 'net', 'thấy', 'không thể', 'thiếu', 'nhau', ',', 'chị', 'và', 'người', 'ấy', 'hẹn', 'gặp', 'ở', 'một', 'cây xăng']
Theo dấu hiệu nhận mặt, chị thấy anh không như mình nghĩ và chỉ chừng thước rưỡi nên	['Theo', 'dấu hiệu', 'nhận mặt', ',', 'chị', 'thấy', 'anh', 'không', 'như', 'mình', 'nghĩ', 'và', 'chỉ', 'chừng', 'thước', 'rưỡi', 'nên']
Hai ngày sau chị mới dám liên lạc, dù trong lòng cũng buồn nhưng đành cáo bệnh xin lỗi và tạm biệt không hẹn ngày gặp lại	['Hai', 'ngày', 'sau', 'chị', 'mới', 'dám', 'liên lạc', ',', 'dù', 'trong', 'lòng', 'cũng', 'buồn', 'nhưng', 'đành', 'cáo bệnh', 'xin lỗi', 'và', 'tạm biệt', 'không', 'hẹn', 'ngày', 'gặp', 'lại']
Theo các chuyên gia tâm lý, từ hai nick đến hai tên thật, từ giao lưu trên mạng chuyển sang tình thật là một khoảng cách rất xa	['Theo', 'các', 'chuyên gia', 'tâm lý', ',', 'từ', 'hai', 'nick', 'đến', 'hai', 'tên', 'thật', ',', 'từ', 'giao lưu', 'trên', 'mạng', 'chuyển', 'sang', 'tình thật', 'là', 'một', 'khoảng cách', 'rất', 'xa']
Khi giao tiếp phải có niềm tin, nhưng là niềm tin có cơ sở, xây dựng từ từ qua các kỹ năng xâu chuỗi thông tin	['Khi', 'giao tiếp', 'phải', 'có', 'niềm', 'tin', ',', 'nhưng', 'là', 'niềm', 'tin', 'có', 'cơ sở', ',', 'xây dựng', 'từ từ', 'qua', 'các', 'kỹ năng', 'xâu chuỗi', 'thông tin']
Chuyên gia tư vấn Lý Thị Mai (TP HCM) cho rằng, để tạo niềm tin cho đối tượng, nên chọn nick name nghiêm túc và thể hiện người trên mạng giống với con người thật	['Chuyên gia', 'tư vấn', 'Lý Thị Mai', '(', 'TP HCM', ')', 'cho', 'rằng', ',', 'để', 'tạo', 'niềm', 'tin', 'cho', 'đối tượng', ',', 'nên', 'chọn', 'nick', 'name', 'nghiêm túc', 'và', 'thể hiện', 'người', 'trên', 'mạng', 'giống', 'với', 'con người', 'thật']
Chân thật, biết tôn vinh giá trị bản thân, nhưng không tự cao, tự đại; điều này sẽ làm nên vẻ đẹp tự tin, bản lĩnh mà mọi người dễ cảm nhận và tôn trọng	['Chân thật', ',', 'biết', 'tôn vinh', 'giá trị', 'bản thân', ',', 'nhưng', 'không', 'tự', 'cao', ',', 'tự đại', ';', 'điều', 'này', 'sẽ', 'làm nên', 'vẻ', 'đẹp', 'tự tin', ',', 'bản lĩnh', 'mà', 'mọi', 'người', 'dễ', 'cảm nhận', 'và', 'tôn trọng']
Ngoài ra, giao tiếp thường nhật và trên mạng đều cần có kỹ năng và văn hóa ứng xử, luôn tỉnh táo và khi thấy có điều lạ thì	['Ngoài ra', ',', 'giao tiếp', 'thường nhật', 'và', 'trên', 'mạng', 'đều', 'cần', 'có', 'kỹ năng', 'và', 'văn hóa', 'ứng xử', ',', 'luôn', 'tỉnh táo', 'và', 'khi', 'thấy', 'có', 'điều', 'lạ', 'thì']
trao đổi ngay với người có kinh nghiệm hoặc nhà tâm lý	['trao đổi', 'ngay', 'với', 'người', 'có', 'kinh nghiệm', 'hoặc', 'nhà', 'tâm lý']
Việc có tình yêu thật sự trên mạng hay không là tùy thuộc vào đối tượng sử dụng mạng	['Việc', 'có', 'tình yêu', 'thật sự', 'trên', 'mạng', 'hay', 'không', 'là', 'tùy', 'thuộc', 'vào', 'đối tượng', 'sử dụng', 'mạng']
Chi tiền để được làm tiếp viên quán đèn mờ	['Chi', 'tiền', 'để', 'được', 'làm', 'tiếp viên', 'quán', 'đèn', 'mờ']
TP HCM nở rộ kiểu quán bia, cà phê nửa nạc nửa mỡ	['TP', 'HCM', 'nở rộ', 'kiểu', 'quán', 'bia', ',', 'cà phê', 'nửa', 'nạc', 'nửa', 'mỡ']
Ở đây ôm không ra ôm, đàng hoàng không ra đàng hoàng, nhưng lúc nào cũng đông khách	['Ở', 'đây', 'ôm', 'không', 'ra', 'ôm', ',', 'đàng hoàng', 'không', 'ra', 'đàng hoàng', ',', 'nhưng', 'lúc nào', 'cũng', 'đông', 'khách']
Các quán này tồn tại được vì cơ quan chức năng khó tìm ra sai phạm rõ ràng để xử lý	['Các', 'quán', 'này', 'tồn tại', 'được', 'vì', 'cơ quan chức năng', 'khó', 'tìm', 'ra', 'sai phạm', 'rõ ràng', 'để', 'xử lý']
Còn khách nườm nượp đến là vì có em út chiều chuộng mà chẳng mất nhiều tiền	['Còn', 'khách', 'nườm nượp', 'đến', 'là', 'vì', 'có', 'em út', 'chiều chuộng', 'mà', 'chẳng', 'mất', 'nhiều', 'tiền']
Tiếp viên lãnh lương tháng chỉ dăm bảy trăm nghìn đồng, phải biết "chiều" khách hết cỡ song không được tới bến	['Tiếp viên', 'lãnh', 'lương', 'tháng', 'chỉ', 'dăm bảy', 'trăm', 'nghìn', 'đồng', ',', 'phải biết', '"', 'chiều', '"', 'khách', 'hết', 'cỡ', 'song', 'không', 'được', 'tới', 'bến']
Chính chiêu này đã thu hút khách ngày càng đông	['Chính', 'chiêu', 'này', 'đã', 'thu hút', 'khách', 'ngày càng', 'đông']
Hàng chục quán cà phê ở xã Tân Túc, huyện Bình Chánh, TP HCM nổi tiếng chiều khách, luôn có em út mặc đồ thiếu vải quậy bạo	['Hàng', 'chục', 'quán', 'cà phê', 'ở', 'xã', 'Tân Túc', ',', 'huyện', 'Bình Chánh', ',', 'TP', 'HCM', 'nổi tiếng', 'chiều', 'khách', ',', 'luôn', 'có', 'em út', 'mặc', 'đồ', 'thiếu', 'vải', 'quậy', 'bạo']
Khách vừa tới, lập tức có hai cô gái mặc váy ngắn màu hồng chạy đến kéo tay vào một cái bàn còn trống, bị che khuất bởi chậu hoa kiểng	['Khách', 'vừa', 'tới', ',', 'lập tức', 'có', 'hai', 'cô', 'gái', 'mặc', 'váy', 'ngắn', 'màu', 'hồng', 'chạy', 'đến', 'kéo', 'tay', 'vào', 'một', 'cái', 'bàn', 'còn', 'trống', ',', 'bị', 'che khuất', 'bởi', 'chậu hoa', 'kiểng']
Cô gái tên Linh nhảy tót vào lòng khách mơn trớn, rồi ôm rịt lấy, âu yếm như đôi tình nhân	['Cô', 'gái', 'tên', 'Linh', 'nhảy tót', 'vào', 'lòng', 'khách', 'mơn trớn', ',', 'rồi', 'ôm', 'rịt', 'lấy', ',', 'âu yếm', 'như', 'đôi', 'tình nhân']
Em lên thành phố hơn 2 năm rồi, lúc đầu phụ bán quán ăn, sau thất nghiệp	['Em', 'lên', 'thành phố', 'hơn', '2', 'năm', 'rồi', ',', 'lúc', 'đầu', 'phụ', 'bán', 'quán', 'ăn', ',', 'sau', 'thất nghiệp']
Thế là em đến bán quán ở đây, gần năm rồi, nàng thỏ thẻ	['Thế là', 'em', 'đến', 'bán', 'quán', 'ở', 'đây', ',', 'gần', 'năm', 'rồi', ',', 'nàng', 'thỏ thẻ']
Chợt cô lớn tiếng: Em phải cúng hết tháng lương đầu tiên đấy	['Chợt', 'cô', 'lớn tiếng', ':', 'Em', 'phải', 'cúng', 'hết', 'tháng', 'lương', 'đầu tiên', 'đấy']
Thấy tôi ngơ ngác không hiểu, Linh bảo: Thì đưa tiền cò cho anh Tám	['Thấy', 'tôi', 'ngơ ngác', 'không', 'hiểu', ',', 'Linh', 'bảo', ':', 'Thì', 'đưa', 'tiền cò', 'cho', 'anh', 'Tám']
Cư xá Bà Điểm, huyện Hóc Môn cũng có hàng chục quán cà phê giải khát nằm san sát nhau, quán nào cũng có tiếp viên trẻ trung, ăn mặc khêu gợi	['Cư xá', 'Bà Điểm', ',', 'huyện', 'Hóc Môn', 'cũng', 'có', 'hàng', 'chục', 'quán', 'cà phê', 'giải khát', 'nằm', 'san sát', 'nhau', ',', 'quán', 'nào', 'cũng', 'có', 'tiếp viên', 'trẻ trung', ',', 'ăn mặc', 'khêu gợi']
Cô gái tên Hoa từ Tây Ninh đến TP HCM làm nghề may	['Cô', 'gái', 'tên', 'Hoa', 'từ', 'Tây Ninh', 'đến', 'TP', 'HCM', 'làm', 'nghề', 'may']
Hàng ế ẩm, Hoa phải nằm chờ ở nhà thuê gần 3 tháng, chịu hết xiết, lân la dò hỏi việc làm, chẳng nơi nào nhận	['Hàng', 'ế ẩm', ',', 'Hoa', 'phải', 'nằm', 'chờ', 'ở', 'nhà', 'thuê', 'gần', '3', 'tháng', ',', 'chịu', 'hết', 'xiết', ',', 'lân la', 'dò hỏi', 'việc làm', ',', 'chẳng', 'nơi', 'nào', 'nhận']
Có người giới thiệu, cô gặp một tay cò và được dẫn vào đây làm việc, mỗi tháng được 500	['Có', 'người', 'giới thiệu', ',', 'cô', 'gặp', 'một', 'tay', 'cò', 'và', 'được', 'dẫn', 'vào', 'đây', 'làm việc', ',', 'mỗi', 'tháng', 'được', '500']
Đến giờ Hoa vẫn chưa có lương, vì theo thỏa thuận cô phải đưa cho cò 3 tháng lương	['Đến', 'giờ', 'Hoa', 'vẫn', 'chưa', 'có', 'lương', ',', 'vì', 'theo', 'thỏa thuận', 'cô', 'phải', 'đưa', 'cho', 'cò', '3', 'tháng', 'lương']
Nếu Hoa không chịu chung tiền thì phải đi Vũng Tàu chơi với hắn 2 ngày	['Nếu', 'Hoa', 'không', 'chịu', 'chung', 'tiền', 'thì', 'phải', 'đi', 'Vũng Tàu', 'chơi', 'với', 'hắn', '2', 'ngày']
Cô gái đành phải đưa tiền đủ vì không muốn trao thân	['Cô', 'gái', 'đành', 'phải', 'đưa', 'tiền', 'đủ', 'vì', 'không', 'muốn', 'trao', 'thân']
Cò tiếp viên quậy xuất hiện trước yêu cầu của nhiều quán nhậu, quán cà phê giải khát	['Cò', 'tiếp viên', 'quậy', 'xuất hiện', 'trước', 'yêu cầu', 'của', 'nhiều', 'quán', 'nhậu', ',', 'quán', 'cà phê', 'giải khát']
Thông thường số tiền chủ quán phải trả cho cò 100	['Thông thường', 'số', 'tiền', 'chủ', 'quán', 'phải', 'trả', 'cho', 'cò', '100']
Một cò tên Giang kể: Bà chủ quán này mới nhờ kiếm giùm 2 em phục vụ	['Một', 'cò', 'tên', 'Giang', 'kể', ':', 'Bà', 'chủ', 'quán', 'này', 'mới', 'nhờ', 'kiếm', 'giùm', '2', 'em', 'phục vụ']
Tôi phải tìm ở một số nhà trọ, dẫn về cho bà xem mặt	['Tôi', 'phải', 'tìm', 'ở', 'một số', 'nhà trọ', ',', 'dẫn', 'về', 'cho', 'bà', 'xem', 'mặt']
Một số quán cũng đến gặp tôi nhờ kiếm tiếp viên quậy giùm, bởi tôi biết con gái ở quê thất nghiệp đầy ở các phòng trọ, vào đó ngon ngọt một tí là xong ngay	['Một số', 'quán', 'cũng', 'đến', 'gặp', 'tôi', 'nhờ', 'kiếm', 'tiếp viên', 'quậy', 'giùm', ',', 'bởi', 'tôi', 'biết', 'con gái', 'ở', 'quê', 'thất nghiệp', 'đầy', 'ở', 'các', 'phòng', 'trọ', ',', 'vào', 'đó', 'ngon ngọt', 'một tí', 'là', 'xong', 'ngay']
Một số bác tài xe ôm hiện nay cũng là những tay cò thực thụ	['Một số', 'bác', 'tài', 'xe ôm', 'hiện nay', 'cũng', 'là', 'những', 'tay', 'cò', 'thực thụ']
Nhiều chủ quán còn đặt hàng thẳng cho chúng tôi, phải là con gái quậy bạo họ mới nhận vào làm, một cò nói	['Nhiều', 'chủ', 'quán', 'còn', 'đặt hàng', 'thẳng', 'cho', 'chúng tôi', ',', 'phải', 'là', 'con gái', 'quậy', 'bạo', 'họ', 'mới', 'nhận', 'vào', 'làm', ',', 'một', 'cò', 'nói']
Hạnh vừa tròn 18 tuổi, nhà nghèo đông anh em	['Hạnh', 'vừa', 'tròn', '18', 'tuổi', ',', 'nhà', 'nghèo', 'đông', 'anh em']
Một ngày, mẹ cô gặp lại người bạn cũ sống ở TP HCM	['Một', 'ngày', ',', 'mẹ', 'cô', 'gặp', 'lại', 'người', 'bạn', 'cũ', 'sống', 'ở', 'TP', 'HCM']
Hạnh được nhận vào quán Lam làm với mức lương 700	['Hạnh', 'được', 'nhận', 'vào', 'quán', 'Lam làm', 'với', 'mức', 'lương', '700']
Chủ quán buộc cô phải ngồi nói chuyện với khách, nếu họ có yêu cầu thì chiều	['Chủ', 'quán', 'buộc', 'cô', 'phải', 'ngồi', 'nói chuyện', 'với', 'khách', ',', 'nếu', 'họ', 'có', 'yêu cầu', 'thì', 'chiều']
Vào đây người nào cũng đòi hỏi em phải chiều họ thế này thế khác, lúc đầu em rất ngại nhưng sau cũng quen, chúng em bán quán nước ở đây người nào cũng có nỗi khổ riêng, phải đưa thân ra cho họ sờ soạng, vuốt ve	['Vào', 'đây', 'người', 'nào', 'cũng', 'đòi hỏi', 'em', 'phải', 'chiều', 'họ', 'thế', 'này', 'thế', 'khác', ',', 'lúc', 'đầu', 'em', 'rất', 'ngại', 'nhưng', 'sau', 'cũng', 'quen', ',', 'chúng em', 'bán', 'quán', 'nước', 'ở', 'đây', 'người', 'nào', 'cũng', 'có', 'nỗi', 'khổ', 'riêng', ',', 'phải', 'đưa', 'thân', 'ra', 'cho', 'họ', 'sờ soạng', ',', 'vuốt ve']
Có đứa còn bị mấy bà vợ đánh ghen tại quán, nữ tiếp viên tâm sự	['Có', 'đứa', 'còn', 'bị', 'mấy', 'bà', 'vợ', 'đánh ghen', 'tại', 'quán', ',', 'nữ', 'tiếp viên', 'tâm sự']
Cũng theo lời Hạnh, người đàn bà quen biết với mẹ là một cò tiếp viên quậy nổi tiếng ở khu vực này	['Cũng', 'theo', 'lời', 'Hạnh', ',', 'người', 'đàn bà', 'quen biết', 'với', 'mẹ', 'là', 'một', 'cò', 'tiếp viên', 'quậy', 'nổi tiếng', 'ở', 'khu vực', 'này']
Do quen biết nên bà ta không đòi hỏi cô phải trả tiền cò	['Do', 'quen biết', 'nên', 'bà', 'ta', 'không', 'đòi hỏi', 'cô', 'phải', 'trả', 'tiền', 'cò']
Nhưng Hạnh cũng phải chi cho chủ quán hết 200	['Nhưng', 'Hạnh', 'cũng', 'phải', 'chi', 'cho', 'chủ', 'quán', 'hết', '200']
000 đồng, những cô gái khác thì bà ta lấy trước một tháng lương	['000', 'đồng', ',', 'những', 'cô', 'gái', 'khác', 'thì', 'bà', 'ta', 'lấy', 'trước', 'một', 'tháng', 'lương']
San bán quán cà phê trên đường Phan Văn Trị, quận Bình Thạnh	['San', 'bán', 'quán', 'cà phê', 'trên', 'đường', 'Phan Văn Trị', ',', 'quận', 'Bình Thạnh']
Lúc đầu, cô đi làm ở một công ty may, buồn chuyện tình cảm, San nghe theo lời bạn bè đi bán bia ở một nhà hàng trên đường Phan Đăng Lưu	['Lúc', 'đầu', ',', 'cô', 'đi', 'làm', 'ở', 'một', 'công ty', 'may', ',', 'buồn', 'chuyện', 'tình cảm', ',', 'San', 'nghe', 'theo', 'lời', 'bạn bè', 'đi', 'bán', 'bia', 'ở', 'một', 'nhà hàng', 'trên', 'đường', 'Phan Đăng Lưu']
Muốn được vào làm, San phải chi trả tiền công cho người giới thiệu, kế đến là tiền hoa hồng cho người trực tiếp quản lý, điều hành công việc	['Muốn', 'được', 'vào', 'làm', ',', 'San', 'phải', 'chi trả', 'tiền', 'công', 'cho', 'người', 'giới thiệu', ',', 'kế', 'đến', 'là', 'tiền', 'hoa hồng', 'cho', 'người', 'trực tiếp', 'quản lý', ',', 'điều hành', 'công việc']
Về sau, nhà hàng ế ẩm, sa thải nhiều nhân viên, trong đó có San	['Về', 'sau', ',', 'nhà hàng', 'ế ẩm', ',', 'sa thải', 'nhiều', 'nhân viên', ',', 'trong', 'đó', 'có', 'San']
Cô đến một quán cà phê trên đường Phan Văn Trị hơn một năm qua, làm trò vui cho khách làng chơi háo sắc, bất kể tuổi tác, ngành nghề, miễn có tiền là được	['Cô', 'đến', 'một', 'quán', 'cà phê', 'trên', 'đường', 'Phan Văn Trị', 'hơn', 'một', 'năm', 'qua', ',', 'làm', 'trò vui', 'cho', 'khách', 'làng chơi', 'háo sắc', ',', 'bất kể', 'tuổi tác', ',', 'ngành nghề', ',', 'miễn', 'có', 'tiền', 'là', 'được']
"Nếu bạn là người Phần Lan, bạn đã trúng số", S	['"', 'Nếu', 'bạn', 'là', 'người', 'Phần Lan', ',', 'bạn', 'đã', 'trúng số', '"', ',', 'S']
Nygard, một giảng viên đại học ở Helsinki vừa ru đứa con nhỏ đang ngủ trên tay vừa bình thản nói	['Nygard', ',', 'một', 'giảng viên', 'đại học', 'ở', 'Helsinki', 'vừa', 'ru', 'đứa', 'con', 'nhỏ', 'đang', 'ngủ', 'trên', 'tay', 'vừa', 'bình thản', 'nói']
Như những người dân Phần Lan khác, cả Nygard và cô vợ Sirelius đều không phải trả một xu học phí nào ở đại học, dù họ tốn hết 7 năm mới hoàn thành nó	['Như', 'những', 'người', 'dân', 'Phần Lan', 'khác', ',', 'cả', 'Nygard', 'và', 'cô', 'vợ', 'Sirelius', 'đều', 'không', 'phải', 'trả', 'một', 'xu', 'học phí', 'nào', 'ở', 'đại học', ',', 'dù', 'họ', 'tốn', 'hết', '7', 'năm', 'mới', 'hoàn thành', 'nó']
Sirelius cũng được chăm sóc y tế hoàn toàn miễn phí trong suốt thời gian mang thai và sinh con	['Sirelius', 'cũng', 'được', 'chăm sóc', 'y tế', 'hoàn toàn', 'miễn phí', 'trong', 'suốt', 'thời gian', 'mang', 'thai', 'và', 'sinh', 'con']
Đến khi đứa trẻ chào đời, cô nghỉ làm cả 11 tháng mà không phải bận tâm gì nhiều vì chính phủ có nhiệm vụ trả đến 60% lương tháng cho cô	['Đến', 'khi', 'đứa', 'trẻ', 'chào đời', ',', 'cô', 'nghỉ', 'làm', 'cả', '11', 'tháng', 'mà', 'không', 'phải', 'bận tâm', 'gì', 'nhiều', 'vì', 'chính phủ', 'có', 'nhiệm vụ', 'trả', 'đến', '60', '%', 'lương', 'tháng', 'cho', 'cô']
Năm tới, hai vợ chồng sẽ tha hồ lựa chọn giữa các nhà trẻ sử dụng tiếng Phần Lan, Thụy Điển, Anh hoặc Tây Ban Nha để gửi con, còn chính phủ thì tha hồ	['Năm tới', ',', 'hai', 'vợ chồng', 'sẽ', 'tha hồ', 'lựa chọn', 'giữa', 'các', 'nhà trẻ', 'sử dụng', 'tiếng', 'Phần Lan', ',', 'Thụy Điển', ',', 'Anh', 'hoặc', 'Tây', 'Ban Nha', 'để', 'gửi', 'con', ',', 'còn', 'chính phủ', 'thì', 'tha hồ']
Trong trường hợp bị mất việc, trợ cấp thất nghiệp của họ trong suốt 18 tháng sẽ bằng 70% lương toàn phần	['Trong', 'trường hợp', 'bị', 'mất', 'việc', ',', 'trợ cấp', 'thất nghiệp', 'của', 'họ', 'trong', 'suốt', '18', 'tháng', 'sẽ', 'bằng', '70', '%', 'lương', 'toàn phần']
Đến khi nghỉ hưu, hai vợ chồng cũng sẽ không phải lo lắng gì nhiều vì lương hưu trung bình của một người Phần Lan bằng khoảng 60% thu nhập trong những tháng cuối cùng họ còn đi làm	['Đến', 'khi', 'nghỉ', 'hưu', ',', 'hai', 'vợ chồng', 'cũng', 'sẽ', 'không', 'phải', 'lo lắng', 'gì', 'nhiều', 'vì', 'lương', 'hưu', 'trung bình', 'của', 'một', 'người', 'Phần Lan', 'bằng', 'khoảng', '60', '%', 'thu nhập', 'trong', 'những', 'tháng', 'cuối cùng', 'họ', 'còn', 'đi', 'làm']
Tất nhiên, chuyện gì cũng có cái giá của nó	['Tất nhiên', ',', 'chuyện', 'gì', 'cũng', 'có', 'cái', 'giá', 'của', 'nó']
Để được hưởng một chính sách bảo trợ xã hội dễ chịu đến như vậy, người Phần Lan phải đóng thuế thu nhập thuộc loại cao nhất thế giới	['Để', 'được', 'hưởng', 'một', 'chính sách', 'bảo trợ', 'xã hội', 'dễ chịu', 'đến', 'như', 'vậy', ',', 'người', 'Phần Lan', 'phải', 'đóng', 'thuế', 'thu nhập', 'thuộc', 'loại', 'cao', 'nhất', 'thế giới']
Với Sirelius chẳng hạn, nếu tiếp tục đi làm bình thường sau thời gian nghỉ hộ sản, cô sẽ phải trả 45% thu nhập cho sở thuế	['Với', 'Sirelius', 'chẳng hạn', ',', 'nếu', 'tiếp tục', 'đi', 'làm', 'bình thường', 'sau', 'thời gian', 'nghỉ', 'hộ sản', ',', 'cô', 'sẽ', 'phải', 'trả', '45', '%', 'thu nhập', 'cho', 'sở', 'thuế']
Nhưng cô không chống lại điều này: "Tôi thấy rằng đó là cách để xã hội vận hành trôi chảy	['Nhưng', 'cô', 'không', 'chống', 'lại', 'điều', 'này', ':', '"', 'Tôi', 'thấy', 'rằng', 'đó', 'là', 'cách', 'để', 'xã hội', 'vận hành', 'trôi chảy']
Hệ thống phúc lợi của nhà nước không thể hoạt động được nếu mỗi người không góp phần"	['Hệ thống', 'phúc lợi', 'của', 'nhà nước', 'không thể', 'hoạt động', 'được', 'nếu', 'mỗi', 'người', 'không', 'góp phần', '"']
- Phần Lan là quê hương của Nokia, hãng điện thoại di động lớn nhất thế giới	['-', 'Phần Lan', 'là', 'quê hương', 'của', 'Nokia', ',', 'hãng', 'điện thoại di động', 'lớn', 'nhất', 'thế giới']
Nokia có nhà máy ở 10 nước và trung tâm R&amp;D ở 15 nước	['Nokia', 'có', 'nhà máy', 'ở', '10', 'nước', 'và', 'trung tâm', 'R', '&', 'amp', ';', 'D', 'ở', '15', 'nước']
- Đóng phạt dựa trên thu nhập là một trong rất nhiều chính sách nhằm tạo sự công bằng xã hội của Phần Lan	['-', 'Đóng', 'phạt', 'dựa', 'trên', 'thu nhập', 'là', 'một', 'trong', 'rất', 'nhiều', 'chính sách', 'nhằm', 'tạo', 'sự', 'công bằng', 'xã hội', 'của', 'Phần Lan']
"Tội" của ông ta là kiếm đến 8 triệu USD/năm	['"', 'Tội', '"', 'của', 'ông', 'ta', 'là', 'kiếm', 'đến', '8', 'triệu', 'USD', '/', 'năm']
50 năm trước, chẳng mấy ai biết đến cái tên Phần Lan, một miền đất xa xôi hẻo lánh nằm bên rìa thế giới chỉ có những người nông dân lam lũ, những anh tiều phu ít học	['50', 'năm', 'trước', ',', 'chẳng', 'mấy', 'ai', 'biết', 'đến', 'cái', 'tên', 'Phần Lan', ',', 'một', 'miền', 'đất', 'xa xôi', 'hẻo lánh', 'nằm', 'bên', 'rìa', 'thế giới', 'chỉ', 'có', 'những', 'người', 'nông dân', 'lam lũ', ',', 'những', 'anh', 'tiều phu', 'ít', 'học']
Ngày nay, Phần Lan liên tục được đánh giá là nền kinh tế cạnh tranh nhất thế giới, là nơi người dân có học thức cao nhất trong khối các nước công nghiệp và là quốc gia sở hữu một hệ thống phúc lợi tạo ra một trong những xã hội bình đẳng nhất hành tinh này	['Ngày nay', ',', 'Phần Lan', 'liên tục', 'được', 'đánh giá', 'là', 'nền', 'kinh tế', 'cạnh tranh', 'nhất', 'thế giới', ',', 'là', 'nơi', 'người dân', 'có', 'học thức', 'cao', 'nhất', 'trong', 'khối', 'các', 'nước', 'công nghiệp', 'và', 'là', 'quốc gia', 'sở hữu', 'một', 'hệ thống', 'phúc lợi', 'tạo', 'ra', 'một', 'trong', 'những', 'xã hội', 'bình đẳng', 'nhất', 'hành tinh', 'này']
Bí quyết ? Phần Lan có lẽ là một ngoại lệ ở châu Âu với một xã hội đồng nhất, trong đó cộng đồng thiểu số chỉ chiếm 6% và tỷ lệ dân nhập cư rất thấp	['Bí quyết', '?', 'Phần Lan', 'có lẽ', 'là', 'một', 'ngoại lệ', 'ở', 'châu Âu', 'với', 'một', 'xã hội đồng nhất', ',', 'trong', 'đó', 'cộng đồng', 'thiểu số', 'chỉ', 'chiếm', '6', '%', 'và', 'tỷ lệ dân', 'nhập cư', 'rất', 'thấp']
Nhưng nhiêu đó không đủ làm nên sự thành công	['Nhưng', 'nhiêu', 'đó', 'không', 'đủ', 'làm nên', 'sự', 'thành công']
Nghiên cứu của Tổ chức Phát triển và hợp tác kinh tế (OECD) cho thấy người dân đất nước lạnh giá này có một nền giáo dục tốt nhất thế giới	['Nghiên cứu', 'của', 'Tổ chức', 'Phát triển', 'và', 'hợp tác', 'kinh tế', '(', 'OECD', ')', 'cho', 'thấy', 'người', 'dân', 'đất nước', 'lạnh giá', 'này', 'có', 'một', 'nền', 'giáo dục', 'tốt', 'nhất', 'thế giới']
Chú trọng đặc biệt cho công tác nghiên cứu và phát triển (R&amp;D) là một yếu tố khác làm nên câu chuyện thành công của Phần Lan, đất nước chi đến 3,6% GDP cho R&amp;D, tức cao thứ nhì châu Âu, chỉ sau Thụy Điển	['Chú trọng', 'đặc biệt', 'cho', 'công tác', 'nghiên cứu', 'và', 'phát triển', '(', 'R', '&', 'amp', ';', 'D', ')', 'là', 'một', 'yếu tố', 'khác', 'làm nên', 'câu chuyện', 'thành công', 'của', 'Phần Lan', ',', 'đất nước', 'chi', 'đến', '3,6', '%', 'GDP', 'cho', 'R', '&', 'amp', ';', 'D', ',', 'tức', 'cao', 'thứ', 'nhì', 'châu Âu', ',', 'chỉ', 'sau', 'Thụy Điển']
Số tiền chi cho R&amp;D vẫn ở mức cao ngất ngưởng ngay cả trong thời kỳ đen tối nhất, khi cuộc khủng hoảng kinh tế xảy ra hồi đầu thập niên 90	['Số', 'tiền', 'chi', 'cho', 'R', '&', 'amp', ';', 'D', 'vẫn', 'ở', 'mức', 'cao ngất ngưởng', 'ngay', 'cả', 'trong', 'thời kỳ', 'đen tối', 'nhất', ',', 'khi', 'cuộc', 'khủng hoảng kinh tế', 'xảy', 'ra', 'hồi đầu', 'thập niên', '90']
Sống sót sau 14 ngày đêm lạc một mình trên biển	['Sống sót', 'sau', '14', 'ngày đêm', 'lạc', 'một mình', 'trên', 'biển']
Ngư dân Bùi Đức Phục cùng chiếc thuyền thúng đã lênh đênh trên biển hơn 1	['Ngư dân', 'Bùi Đức Phục', 'cùng', 'chiếc', 'thuyền thúng', 'đã', 'lênh đênh', 'trên', 'biển', 'hơn', '1']
Một mình giữa biển khơi, không lương thực và nước uống, 3 củ hành khô giúp anh cầm cự trong 3 ngày	['Một mình', 'giữa', 'biển', 'khơi', ',', 'không', 'lương thực', 'và', 'nước', 'uống', ',', '3', 'củ hành', 'khô', 'giúp', 'anh', 'cầm cự', 'trong', '3', 'ngày']
11 ngày sau là bắt cá ăn sống và uống nước tiểu cho qua cơn khát	['11', 'ngày', 'sau', 'là', 'bắt', 'cá', 'ăn sống', 'và', 'uống', 'nước tiểu', 'cho', 'qua', 'cơn', 'khát']
Khi phát hiện ngư dân Bùi Đức Phục (35 tuổi) mất tích, chủ tàu câu mực Đặng Ngọc Tròn cho tàu chạy tới chạy lui ở vùng biển quanh đảo Song Tử Tây (thuộc quần đảo Trường Sa) tìm kiếm hai ngày liền nhưng chẳng thấy	['Khi', 'phát hiện', 'ngư dân', 'Bùi Đức Phục', '(', '35', 'tuổi', ')', 'mất tích', ',', 'chủ', 'tàu', 'câu', 'mực', 'Đặng Ngọc Tròn', 'cho', 'tàu', 'chạy', 'tới', 'chạy', 'lui', 'ở', 'vùng biển', 'quanh', 'đảo', 'Song Tử Tây', '(', 'thuộc', 'quần đảo', 'Trường Sa', ')', 'tìm kiếm', 'hai', 'ngày', 'liền', 'nhưng', 'chẳng', 'thấy']
5 ngày, rồi 10 ngày trôi qua, hy vọng anh được cứu sống trở thành vô vọng	['5', 'ngày', ',', 'rồi', '10', 'ngày', 'trôi', 'qua', ',', 'hy vọng', 'anh', 'được', 'cứu', 'sống', 'trở thành', 'vô vọng']
Gia đình chuẩn bị lập bàn thờ thì đến ngày thứ 14 tin từ biển đưa về: Anh Phục đã được cứu	['Gia đình', 'chuẩn bị', 'lập', 'bàn thờ', 'thì', 'đến', 'ngày', 'thứ', '14', 'tin', 'từ', 'biển', 'đưa', 'về', ':', 'Anh', 'Phục', 'đã', 'được', 'cứu']
Ngày 18/5, sau khi đưa lên khoang đầy đủ gạo, nước ngọt, xăng dầu, chiếc tàu câu mực công suất 45 CV của anh Đặng Ngọc Tròn (Quảng Ngãi) mang số hiệu QNg-5180 với 12 thuyền viên rời cửa biển Quy Nhơn nhằm hướng quần đảo Trường Sa	['Ngày', '18/5', ',', 'sau', 'khi', 'đưa', 'lên', 'khoang', 'đầy đủ', 'gạo', ',', 'nước ngọt', ',', 'xăng', 'dầu', ',', 'chiếc', 'tàu', 'câu', 'mực', 'công suất', '45', 'CV', 'của', 'anh', 'Đặng Ngọc Tròn', '(', 'Quảng Ngãi', ')', 'mang', 'số hiệu', 'QNg', '-', '5180', 'với', '12', 'thuyền viên', 'rời', 'cửa biển', 'Quy Nhơn', 'nhằm', 'hướng', 'quần đảo', 'Trường Sa']
5 ngày đêm vượt sóng, tàu câu đã đến vùng biển đảo Song Tử Tây	['5', 'ngày đêm', 'vượt', 'sóng', ',', 'tàu', 'câu', 'đã', 'đến', 'vùng biển', 'đảo', 'Song Tử Tây']
Phát hiện nhiều chỗ trên thân tàu bị thủng, anh Tròn quyết định cho tàu cập đảo để sửa chữa	['Phát hiện', 'nhiều', 'chỗ', 'trên', 'thân', 'tàu', 'bị', 'thủng', ',', 'anh', 'Tròn', 'quyết định', 'cho', 'tàu', 'cập', 'đảo', 'để', 'sửa chữa']
Một ngày làm quần quật, tối đến Phục nói với Vũ (một bạn chài trên tàu): Để tao lấy thúng qua tàu bạn mượn đồ về làm cho nhanh	['Một', 'ngày', 'làm', 'quần quật', ',', 'tối', 'đến', 'Phục', 'nói', 'với', 'Vũ', '(', 'một', 'bạn', 'chài', 'trên', 'tàu', ')', ':', 'Để', 'tao', 'lấy', 'thúng', 'qua', 'tàu', 'bạn', 'mượn', 'đồ', 'về', 'làm', 'cho', 'nhanh']
Anh thả thúng xuống biển, lấy dầm chèo, nhưng chưa đến nơi thì bất ngờ gió thổi mạnh	['Anh', 'thả', 'thúng', 'xuống', 'biển', ',', 'lấy', 'dầm', 'chèo', ',', 'nhưng', 'chưa', 'đến', 'nơi', 'thì', 'bất ngờ', 'gió', 'thổi', 'mạnh']
Do máy nổ của chiếc tàu đang tu sửa kêu quá to nên tiếng kêu cứu của Phục chẳng ai nghe	['Do', 'máy nổ', 'của', 'chiếc', 'tàu', 'đang', 'tu sửa', 'kêu', 'quá', 'to', 'nên', 'tiếng', 'kêu', 'cứu', 'của', 'Phục', 'chẳng', 'ai', 'nghe']
Riêng Vũ, sau mấy ngày mệt nhoài sóng gió đã buông mình xuống sàn tàu ngủ	['Riêng', 'Vũ', ',', 'sau', 'mấy', 'ngày', 'mệt nhoài', 'sóng gió', 'đã', 'buông', 'mình', 'xuống', 'sàn', 'tàu', 'ngủ']
Trong khi đó Phục cố sức chống đỡ sóng gió trong đêm đen, hy vọng sáng sớm hôm sau anh em sẽ cứu được mình	['Trong', 'khi', 'đó', 'Phục', 'cố sức', 'chống đỡ', 'sóng gió', 'trong', 'đêm', 'đen', ',', 'hy vọng', 'sáng', 'sớm', 'hôm', 'sau', 'anh em', 'sẽ', 'cứu', 'được', 'mình']
Sáng, anh nhìn quanh chỉ thấy biển mênh mông	['Sáng', ',', 'anh', 'nhìn', 'quanh', 'chỉ', 'thấy', 'biển', 'mênh mông']
Lúc này gió tây đã lặng và gió nồm nam thổi mạnh, Phục nghĩ chẳng còn có thể quay lại tàu	['Lúc', 'này', 'gió tây', 'đã', 'lặng', 'và', 'gió nồm', 'nam', 'thổi', 'mạnh', ',', 'Phục', 'nghĩ', 'chẳng', 'còn', 'có thể', 'quay', 'lại', 'tàu']
Anh nhìn theo vệt máy bay trên trời để định hướng, rồi bơi thúng về phía tây để may ra có chiếc tàu nào đến cứu	['Anh', 'nhìn', 'theo', 'vệt', 'máy bay', 'trên', 'trời', 'để', 'định hướng', ',', 'rồi', 'bơi', 'thúng', 'về', 'phía', 'tây', 'để', 'may ra', 'có', 'chiếc', 'tàu', 'nào', 'đến', 'cứu']
Mái vòm được căng lên (vòm là hai thanh tre căng ngang, hai đầu gắn với tấm nilon thay buồm), anh nhìn xuống sàn thúng thấy có ba củ hành tây	['Mái', 'vòm', 'được', 'căng', 'lên', '(', 'vòm', 'là', 'hai', 'thanh', 'tre', 'căng', 'ngang', ',', 'hai', 'đầu', 'gắn', 'với', 'tấm', 'nilon', 'thay', 'buồm', ')', ',', 'anh', 'nhìn', 'xuống', 'sàn', 'thúng', 'thấy', 'có', 'ba', 'củ hành tây']
3 ngày đi qua, 3 củ hành tây chẳng còn tép nào, cơn khát cháy cổ khiến môi anh phồng rộp	['3', 'ngày', 'đi', 'qua', ',', '3', 'củ hành tây', 'chẳng', 'còn', 'tép', 'nào', ',', 'cơn', 'khát', 'cháy', 'cổ', 'khiến', 'môi', 'anh', 'phồng', 'rộp']
Cơ thể thiếu nước và trời nắng nóng, da cháy từng chòm	['Cơ thể', 'thiếu', 'nước', 'và', 'trời', 'nắng', 'nóng', ',', 'da', 'cháy', 'từng', 'chòm']
Đến ngày thứ 4, hy vọng có một chiếc tàu cứu tới mình đã trở nên mong manh, Phục bắt đầu nghĩ đến mẹ già và cái chết	['Đến', 'ngày', 'thứ', '4', ',', 'hy vọng', 'có', 'một', 'chiếc', 'tàu', 'cứu', 'tới', 'mình', 'đã', 'trở nên', 'mong manh', ',', 'Phục', 'bắt đầu', 'nghĩ', 'đến', 'mẹ già', 'và', 'cái', 'chết']
Rồi cũng một chuyến đi biển, bố của Phục chẳng trở về	['Rồi', 'cũng', 'một', 'chuyến', 'đi', 'biển', ',', 'bố', 'của', 'Phục', 'chẳng', 'trở về']
Hết ông, rồi đến con trai, con rể cũng chết trên biển nên mẹ càng héo hon	['Hết', 'ông', ',', 'rồi', 'đến', 'con trai', ',', 'con rể', 'cũng', 'chết', 'trên', 'biển', 'nên', 'mẹ', 'càng', 'héo hon']
Bây giờ nếu anh chết, mẹ làm sao sống nổi?	['Bây giờ', 'nếu', 'anh', 'chết', ',', 'mẹ', 'làm sao', 'sống', 'nổi', '?']
Nhìn ra phía trước thúng, thấy mớ rác trôi nên đưa tay chụp lấy, may được ba con cá bằng đầu đũa, bỏ vào miệng nhai	['Nhìn', 'ra', 'phía', 'trước', 'thúng', ',', 'thấy', 'mớ', 'rác', 'trôi', 'nên', 'đưa', 'tay', 'chụp', 'lấy', ',', 'may', 'được', 'ba', 'con', 'cá', 'bằng', 'đầu đũa', ',', 'bỏ', 'vào', 'miệng', 'nhai']
Nó nhỏ quá chẳng thể xé thịt ăn nên anh dùng mảnh nắp lon cứa cho con rùa chảy máu hòa với nước tiểu thành một thứ nước nhờn nhờn vừa khai vừa tanh nhưng cố uống để lại sức	['Nó', 'nhỏ', 'quá', 'chẳng thể', 'xé', 'thịt', 'ăn', 'nên', 'anh', 'dùng', 'mảnh', 'nắp', 'lon', 'cứa', 'cho', 'con', 'rùa', 'chảy', 'máu', 'hòa', 'với', 'nước tiểu', 'thành', 'một', 'thứ', 'nước', 'nhờn', 'nhờn', 'vừa', 'khai', 'vừa', 'tanh', 'nhưng', 'cố', 'uống', 'để', 'lại', 'sức']
Ngày thứ 5, thứ 6 anh chẳng bắt được con vật gì để ăn và nước tiểu cũng chỉ có vài giọt nên người lả đi rất nhanh	['Ngày', 'thứ', '5', ',', 'thứ', '6', 'anh', 'chẳng', 'bắt', 'được', 'con', 'vật', 'gì', 'để', 'ăn', 'và', 'nước tiểu', 'cũng', 'chỉ', 'có', 'vài', 'giọt', 'nên', 'người', 'lả', 'đi', 'rất', 'nhanh']
Ngày thứ 10, may mắn có những cơn mưa dông, thúng câu trở thành nơi chứa nước ngọt để uống dần	['Ngày', 'thứ', '10', ',', 'may mắn', 'có', 'những', 'cơn', 'mưa', 'dông', ',', 'thúng', 'câu', 'trở thành', 'nơi', 'chứa', 'nước ngọt', 'để', 'uống', 'dần']
Lúc này, ngoái nhìn thấy hòn đảo Bom Bay (thuộc quần đảo Hoàng Sa) anh mới biết mình đã trôi dạt ra phía bắc trên 300 hải lý	['Lúc', 'này', ',', 'ngoái', 'nhìn', 'thấy', 'hòn', 'đảo', 'Bom Bay', '(', 'thuộc', 'quần đảo', 'Hoàng Sa', ')', 'anh', 'mới', 'biết', 'mình', 'đã', 'trôi dạt', 'ra', 'phía', 'bắc', 'trên', '300', 'hải lý']
Hơn 10 ngày lạc biển, đói, khát, mắt anh hoa lên và không còn sức để chèo thúng	['Hơn', '10', 'ngày', 'lạc', 'biển', ',', 'đói', ',', 'khát', ',', 'mắt', 'anh', 'hoa', 'lên', 'và', 'không', 'còn', 'sức', 'để', 'chèo', 'thúng']
Anh vẫy những con tàu hàng của nước ngoài đi trên biển, nhưng chẳng ai thấy	['Anh', 'vẫy', 'những', 'con', 'tàu', 'hàng', 'của', 'nước ngoài', 'đi', 'trên', 'biển', ',', 'nhưng', 'chẳng', 'ai', 'thấy']
Đến ngày thứ 14, anh thấy được chiếc tàu câu mực nên cô cầm dầm chèo chiếc thúng hướng về nó	['Đến', 'ngày', 'thứ', '14', ',', 'anh', 'thấy', 'được', 'chiếc', 'tàu', 'câu', 'mực', 'nên', 'cô', 'cầm', 'dầm', 'chèo', 'chiếc', 'thúng', 'hướng', 'về', 'nó']
Chủ nhân của chiếc tàu câu mực mang số hiệu ĐN-90159 phát hiện ra anh nên tăng tốc chạy tới cứu	['Chủ nhân', 'của', 'chiếc', 'tàu', 'câu', 'mực', 'mang', 'số hiệu', 'ĐN', '-', '90159', 'phát hiện', 'ra', 'anh', 'nên', 'tăng tốc', 'chạy', 'tới', 'cứu']
Hóa ra, 14 ngày lênh đênh trên biển cả, chiếc thúng của anh theo gió nồm trôi ra hướng bắc rồi bị gió bấc đánh dạt trở lại vùng biển Song Tử Tây	['Hóa ra', ',', '14', 'ngày', 'lênh đênh', 'trên', 'biển cả', ',', 'chiếc', 'thúng', 'của', 'anh', 'theo', 'gió nồm', 'trôi', 'ra', 'hướng', 'bắc', 'rồi', 'bị', 'gió bấc', 'đánh', 'dạt', 'trở lại', 'vùng biển', 'Song Tử Tây']
Phước Lộc Thọ là ba chữ tóm gọn ước mơ của con người thời nông nghiệp, nhưng đến nay, ta vẫn còn thấy trên một số thiệp chúc Tết, hoặc lịch chúc Tết nhắc đến với ba chữ Hán hoặc ba chữ quốc ngữ	['Phước Lộc', 'Thọ', 'là', 'ba', 'chữ', 'tóm', 'gọn', 'ước mơ', 'của', 'con người', 'thời', 'nông nghiệp', ',', 'nhưng', 'đến', 'nay', ',', 'ta', 'vẫn', 'còn', 'thấy', 'trên', 'một số', 'thiệp', 'chúc Tết', ',', 'hoặc', 'lịch', 'chúc Tết', 'nhắc', 'đến', 'với', 'ba', 'chữ', 'Hán', 'hoặc', 'ba', 'chữ quốc ngữ']
nghe qua ai cũng hiểu đại khái là chúc lành	['nghe', 'qua', 'ai', 'cũng', 'hiểu', 'đại khái', 'là', 'chúc', 'lành']
Tượng khắc bằng gỗ hoặc bằng sành sứ về ba ông này được xem như món trưng bày thanh lịch, giàu nghèo sang hèn đều dùng được, như là những ước mơ từ xưa của ông bà để lại	['Tượng', 'khắc', 'bằng', 'gỗ', 'hoặc', 'bằng', 'sành sứ', 'về', 'ba', 'ông', 'này', 'được', 'xem', 'như', 'món', 'trưng bày', 'thanh lịch', ',', 'giàu', 'nghèo', 'sang hèn', 'đều', 'dùng', 'được', ',', 'như là', 'những', 'ước mơ', 'từ', 'xưa', 'của', 'ông bà', 'để', 'lại']
Ông Phước đứng một bên, lắm khi thêm đứa bé ẵm bồng trên tay	['Ông', 'Phước', 'đứng', 'một', 'bên', ',', 'lắm', 'khi', 'thêm', 'đứa', 'bé', 'ẵm', 'bồng', 'trên', 'tay']
Thời nông nghiệp, chưa cơ giới hoá, sức kéo là quan trọng	['Thời', 'nông nghiệp', ',', 'chưa', 'cơ giới hoá', ',', 'sức kéo', 'là', 'quan trọng']
Con trâu, con bò kéo cày, nhưng kẻ đông con, vào lúc nông nghiệp lạc hậu, đất ít, người đông thì con cái dâu rể còn là sức lao động đáng kể để không cần mướn lao động ngoài gia đình	['Con', 'trâu', ',', 'con', 'bò', 'kéo cày', ',', 'nhưng', 'kẻ', 'đông', 'con', ',', 'vào', 'lúc', 'nông nghiệp', 'lạc hậu', ',', 'đất', 'ít', ',', 'người', 'đông', 'thì', 'con cái', 'dâu', 'rể', 'còn', 'là', 'sức lao động', 'đáng kể', 'để', 'không', 'cần', 'mướn', 'lao động', 'ngoài', 'gia đình']
Khi gặp bất trắc, ít ra cũng còn có một hai đứa giữ ruộng đất hoặc quan trọng hơn là nuôi cha mẹ lúc về già	['Khi', 'gặp', 'bất trắc', ',', 'ít ra', 'cũng', 'còn', 'có', 'một', 'hai', 'đứa', 'giữ', 'ruộng đất', 'hoặc', 'quan trọng', 'hơn', 'là', 'nuôi', 'cha mẹ', 'lúc', 'về', 'già']
con cháu, dâu rễ là người già sẽ hưởng một số " trợ cấp hưu trí"	['con cháu', ',', 'dâu', 'rễ', 'là', 'người', 'già', 'sẽ', 'hưởng', 'một số', '"', 'trợ cấp', 'hưu trí', '"']
Vì ham con cháu nên khi xưa lắm người mới hơn 50 tuổi mà đã có cháu nội, cháu ngoại	['Vì', 'ham', 'con cháu', 'nên', 'khi', 'xưa', 'lắm', 'người', 'mới', 'hơn', '50', 'tuổi', 'mà', 'đã', 'có', 'cháu', 'nội', ',', 'cháu', 'ngoại']
Ông Lộc này hiện rõ nét với cái mão cánh chuồn, tay cầm hốt để che mặt khi chầu vua	['Ông', 'Lộc', 'này', 'hiện', 'rõ', 'nét', 'với', 'cái', 'mão', 'cánh', 'chuồn', ',', 'tay', 'cầm', 'hốt', 'để', 'che', 'mặt', 'khi', 'chầu', 'vua']
Ruộng ít dân đông chỉ còn một cách" thăng tiến" là "dùi mài kinh sử" để khi thi đậu làm quan "trước là đẹp mắt sau là ấm thân"	['Ruộng', 'ít', 'dân', 'đông', 'chỉ', 'còn', 'một cách', '"', 'thăng tiến', '"', 'là', '"', 'dùi mài', 'kinh sử', '"', 'để', 'khi', 'thi', 'đậu', 'làm quan', '"', 'trước', 'là', 'đẹp mắt', 'sau', 'là', 'ấm thân', '"']
Dòng họ vẻ vang, lương bổng ngày xưa rất ít, nhưng được nhận đủ thứ quà cáp công khai	['Dòng', 'họ', 'vẻ vang', ',', 'lương bổng', 'ngày xưa', 'rất', 'ít', ',', 'nhưng', 'được', 'nhận', 'đủ', 'thứ', 'quà cáp', 'công khai']
Thời phong kiến, y tế chưa phát triển, chưa có thuốc trụ sinh, tiêm ngừa	['Thời', 'phong kiến', ',', 'y tế', 'chưa', 'phát triển', ',', 'chưa', 'có', 'thuốc', 'trụ sinh', ',', 'tiêm', 'ngừa']
nên sống đến 50 tuổi thì con cháu mừng rỡ bày ra lễ "ngũ tuần" rồi "lục tuần", "thất tuần"	['nên', 'sống', 'đến', '50', 'tuổi', 'thì', 'con cháu', 'mừng rỡ', 'bày', 'ra', 'lễ', '"', 'ngũ', 'tuần', '"', 'rồi', '"', 'lục', 'tuần', '"', ',', '"', 'thất tuần', '"']
Ông Thọ được mô tả như người trán hói, lùn thấp vì theo quan niệm xưa, thân thể co rút lại, trở thành ngọc, tay chống gậy cong queo hoặc tay cầm một trái đào, loại đào tiên ăn vào sống mấy trăm năm tuổi!	['Ông', 'Thọ', 'được', 'mô tả', 'như', 'người', 'trán', 'hói', ',', 'lùn', 'thấp', 'vì', 'theo', 'quan niệm', 'xưa', ',', 'thân thể', 'co', 'rút', 'lại', ',', 'trở thành', 'ngọc', ',', 'tay', 'chống gậy', 'cong', 'queo', 'hoặc', 'tay', 'cầm', 'một', 'trái đào', ',', 'loại', 'đào tiên', 'ăn', 'vào', 'sống', 'mấy', 'trăm', 'năm', 'tuổi', '!']
Tóm lại, mấy cái tượng ông Phước, Lộc, Thọ chỉ là để tượng trưng cho một ước mơ hoài niệm	['Tóm lại', ',', 'mấy', 'cái', 'tượng', 'ông', 'Phước', ',', 'Lộc', ',', 'Thọ', 'chỉ', 'là', 'để', 'tượng trưng', 'cho', 'một', 'ước mơ', 'hoài niệm']
Việc tắm cho các bé ở tuổi đầu đời tưởng đơn giản nhưng đôi khi cũng làm một số người lo lắng	['Việc', 'tắm', 'cho', 'các', 'bé', 'ở', 'tuổi', 'đầu', 'đời', 'tưởng', 'đơn giản', 'nhưng', 'đôi khi', 'cũng', 'làm', 'một số', 'người', 'lo lắng']
Cơ thể bé quá nhỏ, quá trơn; nước trong bồn (chậu) tắm và xà bông có thể vào mũi, vào tai bé; trong những tháng đầu, bé chưa tự giữ thăng bằng được	['Cơ thể', 'bé', 'quá', 'nhỏ', ',', 'quá', 'trơn', ';', 'nước', 'trong', 'bồn', '(', 'chậu', ')', 'tắm', 'và', 'xà bông', 'có thể', 'vào', 'mũi', ',', 'vào', 'tai', 'bé', ';', 'trong', 'những', 'tháng', 'đầu', ',', 'bé', 'chưa', 'tự', 'giữ', 'thăng', 'bằng', 'được']
Theo một số gợi ý sau, bạn có một cách tắm an toàn nhất cho bé	['Theo', 'một số', 'gợi ý', 'sau', ',', 'bạn', 'có', 'một cách', 'tắm', 'an toàn', 'nhất', 'cho', 'bé']
Trước tiên là việc chuẩn bị đầy đủ "dụng cụ" tắm: 2 chậu, khăn khô để lau, xà bông các loại, miếng bọt tắm hoặc khăn mềm để kỳ cọ, quần áo và nước ấm	['Trước tiên', 'là', 'việc', 'chuẩn bị', 'đầy đủ', '"', 'dụng cụ', '"', 'tắm', ':', '2', 'chậu', ',', 'khăn', 'khô', 'để', 'lau', ',', 'xà bông', 'các', 'loại', ',', 'miếng', 'bọt', 'tắm', 'hoặc', 'khăn', 'mềm', 'để', 'kỳ cọ', ',', 'quần áo', 'và', 'nước', 'ấm']
Sẽ rất không an toàn nếu bạn để bé, đặc biệt là khi bé mới chỉ vừa lẫm chẫm biết đi, ở một mình trong bồn tắm để đi lấy những đồ tắm quên chưa chuẩn bị	['Sẽ', 'rất', 'không', 'an toàn', 'nếu', 'bạn', 'để', 'bé', ',', 'đặc biệt', 'là', 'khi', 'bé', 'mới', 'chỉ', 'vừa', 'lẫm chẫm', 'biết', 'đi', ',', 'ở', 'một mình', 'trong', 'bồn tắm', 'để', 'đi', 'lấy', 'những', 'đồ', 'tắm', 'quên', 'chưa', 'chuẩn bị']
Nếu bạn quên một thứ gì đó, hoặc trong khi đang tắm bé có người kêu cửa, có chuông điện thoại, bạn nhất thiết phải đưa bé ra khỏi bồn tắm, ủ bé trong khăn khô và bế bé theo	['Nếu', 'bạn', 'quên', 'một', 'thứ', 'gì', 'đó', ',', 'hoặc', 'trong', 'khi', 'đang', 'tắm', 'bé', 'có', 'người', 'kêu', 'cửa', ',', 'có', 'chuông', 'điện thoại', ',', 'bạn', 'nhất thiết', 'phải', 'đưa', 'bé', 'ra', 'khỏi', 'bồn tắm', ',', 'ủ', 'bé', 'trong', 'khăn', 'khô', 'và', 'bế', 'bé', 'theo']
Cách pha nước tắm: lấy nước lạnh trước rồi pha thêm nước nóng từ từ sau	['Cách', 'pha', 'nước', 'tắm', ':', 'lấy', 'nước', 'lạnh', 'trước', 'rồi', 'pha', 'thêm', 'nước', 'nóng', 'từ từ', 'sau']
Cách này sẽ tránh bị bỏng, cho cả người pha nước lẫn bé	['Cách', 'này', 'sẽ', 'tránh', 'bị', 'bỏng', ',', 'cho', 'cả', 'người', 'pha', 'nước', 'lẫn', 'bé']
Thử độ ấm của nước bằng chỗ khuỷu tay (vì bàn tay bạn có khả năng chịu nhiệt cao, không tương ứng với làn da mỏng manh của bé)	['Thử', 'độ', 'ấm', 'của', 'nước', 'bằng', 'chỗ', 'khuỷu', 'tay', '(', 'vì', 'bàn tay', 'bạn', 'có', 'khả năng', 'chịu nhiệt', 'cao', ',', 'không', 'tương ứng', 'với', 'làn', 'da', 'mỏng manh', 'của', 'bé', ')']
Nên nhớ pha nước trước khi đưa bé lại gần chỗ tắm	['Nên', 'nhớ', 'pha', 'nước', 'trước', 'khi', 'đưa', 'bé', 'lại', 'gần', 'chỗ', 'tắm']
- Dùng khăn mềm, sạch, ẩm rửa mặt, lau phần tai, mũi cho bé trước tiên	['-', 'Dùng', 'khăn', 'mềm', ',', 'sạch', ',', 'ẩm', 'rửa', 'mặt', ',', 'lau', 'phần', 'tai', ',', 'mũi', 'cho', 'bé', 'trước tiên']
- Nhúng phần chân của bé vào nước (có pha xà bông) trước; đỡ đầu và nách của bé bằng một tay; tay kia vớt nước lên các phần còn lại trên người bé	['-', 'Nhúng', 'phần', 'chân', 'của', 'bé', 'vào', 'nước', '(', 'có', 'pha', 'xà bông', ')', 'trước', ';', 'đỡ đầu', 'và', 'nách', 'của', 'bé', 'bằng', 'một', 'tay', ';', 'tay', 'kia', 'vớt', 'nước', 'lên', 'các', 'phần', 'còn', 'lại', 'trên', 'người', 'bé']
- Khi các phần trên thân thể bé đã quen sự tiếp xúc với nước thì có thể cho bé ngồi hẳn trong chậu tắm, một tay giữ phần nách và đỡ sau lưng bé, tay kia kỳ cọ các phần trên thân thể bé hoặc có thể cho bé vầy nước đôi chút	['-', 'Khi', 'các', 'phần', 'trên', 'thân thể', 'bé', 'đã', 'quen', 'sự', 'tiếp xúc', 'với', 'nước', 'thì', 'có thể', 'cho', 'bé', 'ngồi', 'hẳn', 'trong', 'chậu', 'tắm', ',', 'một', 'tay', 'giữ', 'phần', 'nách', 'và', 'đỡ', 'sau', 'lưng', 'bé', ',', 'tay', 'kia', 'kỳ cọ', 'các', 'phần', 'trên', 'thân thể', 'bé', 'hoặc', 'có thể', 'cho', 'bé', 'vầy', 'nước', 'đôi chút']
- Chuyển bé sang chậu nước sạch khác, dùng khăn mềm lướt qua một lượt khắp bề mặt các phần thân thể để "tráng" sạch xà bông, sau đó nhấc bé ra khỏi nước, lau khô bằng khăn mềm, khô và mặc quần áo cho bé	['-', 'Chuyển', 'bé', 'sang', 'chậu', 'nước sạch', 'khác', ',', 'dùng', 'khăn', 'mềm', 'lướt', 'qua', 'một lượt', 'khắp', 'bề mặt', 'các', 'phần', 'thân thể', 'để', '"', 'tráng', '"', 'sạch', 'xà bông', ',', 'sau', 'đó', 'nhấc', 'bé', 'ra', 'khỏi', 'nước', ',', 'lau', 'khô', 'bằng', 'khăn', 'mềm', ',', 'khô', 'và', 'mặc', 'quần áo', 'cho', 'bé']
Bạn có thể dùng xà bông loại nước dùng cho baby để tắm bé, nhưng với các bé sơ sinh thì không cần	['Bạn', 'có thể', 'dùng', 'xà bông', 'loại', 'nước', 'dùng', 'cho', 'baby', 'để', 'tắm', 'bé', ',', 'nhưng', 'với', 'các', 'bé', 'sơ sinh', 'thì', 'không', 'cần']
Nên dùng một cái chậu tắm cho bé thay vì cho bé tắm chung trong bồn tắm của người lớn, vì một cái chậu tắm sẽ dễ dàng di chuyển để đặt ở một nơi kín gió trong ngôi nhà	['Nên', 'dùng', 'một', 'cái', 'chậu', 'tắm', 'cho', 'bé', 'thay vì', 'cho', 'bé', 'tắm', 'chung', 'trong', 'bồn tắm', 'của', 'người lớn', ',', 'vì', 'một', 'cái', 'chậu', 'tắm', 'sẽ', 'dễ dàng', 'di chuyển', 'để', 'đặt', 'ở', 'một', 'nơi', 'kín', 'gió', 'trong', 'ngôi', 'nhà']
Ngoài ra, tắm cho bé bằng bồn tắm người lớn sẽ bị phí nước vì người bé còn nhỏ, không cần lượng nước lớn	['Ngoài ra', ',', 'tắm', 'cho', 'bé', 'bằng', 'bồn tắm', 'người lớn', 'sẽ', 'bị', 'phí', 'nước', 'vì', 'người', 'bé', 'còn', 'nhỏ', ',', 'không', 'cần', 'lượng', 'nước lớn']
Nếu bé có nhiều tóc, việc gội đầu cần phải cẩn thận, nhất là khi gội với xà bông vì xà bông có thể vào mắt bé	['Nếu', 'bé', 'có', 'nhiều', 'tóc', ',', 'việc', 'gội', 'đầu', 'cần', 'phải', 'cẩn thận', ',', 'nhất là', 'khi', 'gội', 'với', 'xà bông', 'vì', 'xà bông', 'có thể', 'vào', 'mắt', 'bé']
Tốt nhất là gội đầu riêng hoặc trước khi tắm	['Tốt', 'nhất', 'là', 'gội', 'đầu', 'riêng', 'hoặc', 'trước', 'khi', 'tắm']
Cách gội: bế bé nằm ngửa, một tay đỡ phần gáy bé, tay kia xoa xà bông, dùng miếng bọt tắm thấm nước lau - xả xà bông từ từ, cẩn thận phần gần mắt, tai bé	['Cách', 'gội', ':', 'bế', 'bé', 'nằm ngửa', ',', 'một', 'tay', 'đỡ', 'phần', 'gáy', 'bé', ',', 'tay', 'kia', 'xoa', 'xà bông', ',', 'dùng', 'miếng', 'bọt', 'tắm', 'thấm', 'nước', 'lau', '-', 'xả', 'xà bông', 'từ từ', ',', 'cẩn thận', 'phần', 'gần', 'mắt', ',', 'tai', 'bé']
Với các bé sơ sinh, trong tuần đầu tiên, bé không cần phải tắm mỗi ngày mà chỉ cần lau (xem ở sau)	['Với', 'các', 'bé', 'sơ sinh', ',', 'trong', 'tuần', 'đầu tiên', ',', 'bé', 'không', 'cần', 'phải', 'tắm', 'mỗi', 'ngày', 'mà', 'chỉ', 'cần', 'lau', '(', 'xem', 'ở', 'sau', ')']
Nhưng sau đó, nên tắm mỗi ngày một lần, theo một thời gian nhất định, giúp bé quen với nhịp sinh học, có sự phân biệt giữa ngày và đêm	['Nhưng', 'sau', 'đó', ',', 'nên', 'tắm', 'mỗi', 'ngày', 'một', 'lần', ',', 'theo', 'một', 'thời gian', 'nhất định', ',', 'giúp', 'bé', 'quen', 'với', 'nhịp sinh học', ',', 'có', 'sự', 'phân biệt', 'giữa', 'ngày', 'và', 'đêm']
- 1 khăn mềm to hơn để lau khô- 1 bình nước ấm	['-', '1', 'khăn', 'mềm', 'to', 'hơn', 'để', 'lau', 'khô', '-', '1', 'bình', 'nước', 'ấm']
Cách làm:- Pha nước ấm trong 1 chậu, nhúng 1 khăn vào	['Cách', 'làm', ':', '-', 'Pha', 'nước', 'ấm', 'trong', '1', 'chậu', ',', 'nhúng', '1', 'khăn', 'vào']
- Thấm lại khăn, lau tay và phần nách, dưới cách tay, lưng bé	['-', 'Thấm', 'lại', 'khăn', ',', 'lau', 'tay', 'và', 'phần', 'nách', ',', 'dưới', 'cách', 'tay', ',', 'lưng', 'bé']
- Pha nước ấm vào chậu còn lại, cởi phần tã để làm vệ sinh phần mông và bộ phận sinh dục cho bé bằng cách nhúng, rửa trong chậu nước với chiếc khăn nhỏ còn lại	['-', 'Pha', 'nước', 'ấm', 'vào', 'chậu', 'còn', 'lại', ',', 'cởi', 'phần', 'tã', 'để', 'làm', 'vệ sinh phần', 'mông', 'và', 'bộ phận', 'sinh dục', 'cho', 'bé', 'bằng', 'cách', 'nhúng', ',', 'rửa', 'trong', 'chậu', 'nước', 'với', 'chiếc', 'khăn', 'nhỏ', 'còn', 'lại']
Lưu ý: Khăn và chậu dùng để rửa mặt và làm vệ sinh nhớ để riêng, chuyên dùng	['Lưu ý', ':', 'Khăn', 'và', 'chậu', 'dùng', 'để', 'rửa', 'mặt', 'và', 'làm', 'vệ sinh', 'nhớ', 'để', 'riêng', ',', 'chuyên dùng']
Ba cô ca sĩ Thy An, Hằng Nga và Thiên Trang của nhóm M	['Ba', 'cô', 'ca sĩ', 'Thy An', ',', 'Hằng Nga', 'và', 'Thiên Trang', 'của', 'nhóm', 'M']
Hợp nhau ở chất giọng tươi trẻ, họ còn rất ăn ý với nhau khi cùng luyện thanh, tập vũ đạo, cùng may mặc và cả lúc	['Hợp', 'nhau', 'ở', 'chất', 'giọng', 'tươi trẻ', ',', 'họ', 'còn', 'rất', 'ăn ý', 'với', 'nhau', 'khi', 'cùng', 'luyện', 'thanh', ',', 'tập', 'vũ đạo', ',', 'cùng', 'may mặc', 'và', 'cả', 'lúc']
M luôn cố gắng giữ nét trang điểm sao cho tự nhiên mà vẫn đẹp	['M', 'luôn', 'cố gắng', 'giữ', 'nét', 'trang điểm', 'sao', 'cho', 'tự nhiên', 'mà', 'vẫn', 'đẹp']
Trước khi trang điểm luôn nhớ thoa lotion để giữ cho da không bị khô vì ảnh hưởng của phấn	['Trước', 'khi', 'trang điểm', 'luôn', 'nhớ', 'thoa', 'lotion', 'để', 'giữ', 'cho', 'da', 'không', 'bị', 'khô', 'vì', 'ảnh hưởng', 'của', 'phấn']
Hằng đêm, cả ba cô gái chỉ ngủ sau khi đắp mặt nạ dưa leo cho sạch da	['Hằng', 'đêm', ',', 'cả', 'ba', 'cô', 'gái', 'chỉ', 'ngủ', 'sau', 'khi', 'đắp', 'mặt nạ', 'dưa leo', 'cho', 'sạch', 'da']
Ngoại trừ những lúc lên sân khấu, chụp ảnh, quay hình	['Ngoại trừ', 'những', 'lúc', 'lên', 'sân khấu', ',', 'chụp', 'ảnh', ',', 'quay', 'hình']
M luôn để mặt tự nhiên, không son phấn, cho làn da của mình được thông thoáng và không sớm bị lão hóa	['M', 'luôn', 'để', 'mặt', 'tự nhiên', ',', 'không', 'son phấn', ',', 'cho', 'làn', 'da', 'của', 'mình', 'được', 'thông thoáng', 'và', 'không', 'sớm', 'bị', 'lão', 'hóa']
Cũng như bao nghệ sĩ đàn chị khác, nhóm M	['Cũng', 'như', 'bao', 'nghệ sĩ', 'đàn', 'chị', 'khác', ',', 'nhóm', 'M']
Để có thể xuất hiện trước khán giả với nhiều phong cách mới, thỉnh thoảng M	['Để', 'có thể', 'xuất hiện', 'trước', 'khán giả', 'với', 'nhiều', 'phong cách', 'mới', ',', 'thỉnh thoảng', 'M']
Cứ nửa tháng một lần, họ lại rủ nhau đi hấp dầu cho tóc không bị xơ và khô vì tác dụng của hóa chất trong thuốc nhuộm	['Cứ', 'nửa', 'tháng', 'một', 'lần', ',', 'họ', 'lại', 'rủ', 'nhau', 'đi', 'hấp', 'dầu', 'cho', 'tóc', 'không', 'bị', 'xơ', 'và', 'khô', 'vì', 'tác dụng', 'của', 'hóa chất', 'trong', 'thuốc nhuộm']
còi xương! Cả ba cô gái trẻ ăn rất khỏe, thường chọn loại thức ăn mát và tuyệt đối không cay	['còi xương', '!', 'Cả', 'ba', 'cô', 'gái', 'trẻ', 'ăn', 'rất', 'khỏe', ',', 'thường', 'chọn', 'loại', 'thức ăn', 'mát', 'và', 'tuyệt đối', 'không', 'cay']
M có thói quen tập thể hình vào khoảng thời gian ngắn ngủi mà mọi người thường nghỉ ngơi: buổi trưa!	['M', 'có', 'thói quen', 'tập thể hình', 'vào', 'khoảng', 'thời gian', 'ngắn ngủi', 'mà', 'mọi', 'người thường', 'nghỉ ngơi', ':', 'buổi', 'trưa', '!']
Viện Gallup (Mỹ): Người Việt là người lạc quan nhất về tương lai đất nước năm nay Hãng truyền hình Mỹ CNN ngày 30/12/2005 công bố kết quả điều tra do Viện thăm dò dư luận Gallup tiến hành tại 66 quốc gia cho biết người dân Việt Nam và người dân Trung Quốc là những người lạc quan nhất về viễn cảnh của đất nước mình trong năm 2006	['Viện Gallup', '(', 'Mỹ', ')', ':', 'Người', 'Việt', 'là', 'người', 'lạc quan', 'nhất', 'về', 'tương lai', 'đất nước', 'năm', 'nay', 'Hãng', 'truyền hình', 'Mỹ', 'CNN', 'ngày', '30/12/2005', 'công bố', 'kết quả', 'điều tra', 'do', 'Viện', 'thăm dò', 'dư luận', 'Gallup', 'tiến hành tại', '66', 'quốc gia', 'cho', 'biết', 'người dân', 'Việt Nam', 'và', 'người', 'dân', 'Trung Quốc', 'là', 'những', 'người', 'lạc quan', 'nhất', 'về', 'viễn cảnh', 'của', 'đất nước', 'mình', 'trong', 'năm', '2006']
Theo kết quả thăm dò, có 75% người Việt Nam được hỏi ý kiến bày tỏ tin tưởng rằng đất nước mình trong năm 2006 sẽ tốt đẹp hơn năm 2005	['Theo', 'kết quả', 'thăm dò', ',', 'có', '75', '%', 'người', 'Việt Nam', 'được', 'hỏi', 'ý kiến', 'bày tỏ', 'tin tưởng', 'rằng', 'đất nước', 'mình', 'trong', 'năm', '2006', 'sẽ', 'tốt đẹp', 'hơn', 'năm', '2005']
Đa số người Trung Quốc được hỏi cũng bày tỏ tin tưởng ở tương lai tốt đẹp của đất nước họ	['Đa số', 'người', 'Trung Quốc', 'được', 'hỏi', 'cũng', 'bày tỏ', 'tin tưởng', 'ở', 'tương lai', 'tốt đẹp', 'của', 'đất nước', 'họ']
Trái lại, có tới 54% người dân Hy Lạp và Bosnia - Herzegovina, 52% người dân Guatemala, 50% người dân Philippines và 47% người dân Serbia Montenegro nghĩ rằng viễn cảnh đất nước họ trong năm 2006 nhiều khả năng sẽ xấu hơn so với năm 2005	['Trái lại', ',', 'có', 'tới', '54', '%', 'người', 'dân', 'Hy Lạp', 'và', 'Bosnia', '-', 'Herzegovina', ',', '52', '%', 'người', 'dân', 'Guatemala', ',', '50', '%', 'người', 'dân', 'Philippines', 'và', '47', '%', 'người', 'dân', 'Serbia Montenegro', 'nghĩ', 'rằng', 'viễn cảnh', 'đất nước', 'họ', 'trong', 'năm', '2006', 'nhiều', 'khả năng', 'sẽ', 'xấu', 'hơn', 'so', 'với', 'năm', '2005']
Công trình hồ thủy lợi Đông Tiển thuộc 2 xã Bình Trị và Bình Định, huyện Thăng Bình (Quảng Nam) đã được qui hoạch từ đầu những năm 1980	['Công trình', 'hồ thủy lợi', 'Đông Tiển', 'thuộc', '2', 'xã', 'Bình Trị', 'và', 'Bình Định', ',', 'huyện', 'Thăng Bình', '(', 'Quảng Nam', ')', 'đã', 'được', 'qui hoạch', 'từ', 'đầu', 'những', 'năm', '1980']
Năm 2000, dự án nghiên cứu khả thi đã được lập	['Năm', '2000', ',', 'dự án', 'nghiên cứu', 'khả thi', 'đã', 'được', 'lập']
Thủ tướng chính phủ đã có ý kiến bằng văn bản ngày 5/9/2003 đồng ý cho đầu tư xây dựng	['Thủ tướng', 'chính phủ', 'đã', 'có', 'ý kiến', 'bằng', 'văn bản', 'ngày', '5/9/2003', 'đồng ý', 'cho', 'đầu tư', 'xây dựng']
UBND tỉnh và huyện Thăng Bình đã chi trên 10 tỉ đồng để khảo sát thiết kế, lập dự án, đền bù giải tỏa và tái định cư cho hơn 170 hộ dân, nhưng đến nay dự án vẫn chưa được phê duyệt, không có vốn thi công	['UBND', 'tỉnh', 'và', 'huyện', 'Thăng Bình', 'đã', 'chi', 'trên', '10', 'tỉ', 'đồng', 'để', 'khảo sát', 'thiết kế', ',', 'lập', 'dự án', ',', 'đền bù', 'giải tỏa', 'và', 'tái định cư', 'cho', 'hơn', '170', 'hộ', 'dân', ',', 'nhưng', 'đến', 'nay', 'dự án', 'vẫn', 'chưa', 'được', 'phê duyệt', ',', 'không', 'có', 'vốn', 'thi công']
Cả tỉnh, huyện và xã đều sốt ruột lo cho một vùng nghèo khó, còn 15 ngàn dân vùng dự án cứ tiếp tục đói nghèo, không có nước tưới cho đồng ruộng lẫn cho sinh hoạt hàng ngày	['Cả', 'tỉnh', ',', 'huyện', 'và', 'xã', 'đều', 'sốt ruột', 'lo', 'cho', 'một', 'vùng', 'nghèo khó', ',', 'còn', '15', 'ngàn', 'dân', 'vùng', 'dự án', 'cứ', 'tiếp tục', 'đói nghèo', ',', 'không', 'có', 'nước', 'tưới', 'cho', 'đồng ruộng', 'lẫn', 'cho', 'sinh hoạt', 'hàng', 'ngày']
Hai xã Bình Trị và Bình Định ở phía Tây huyện Thăng Bình, có địa hình gò đồi cằn cỗi, đời sống thuộc loại thấp nhất trong một huyện nghèo	['Hai', 'xã', 'Bình Trị', 'và', 'Bình Định', 'ở', 'phía', 'Tây', 'huyện', 'Thăng Bình', ',', 'có', 'địa hình', 'gò', 'đồi', 'cằn cỗi', ',', 'đời sống', 'thuộc', 'loại', 'thấp', 'nhất', 'trong', 'một', 'huyện', 'nghèo']
Quanh năm sản xuất nông nghiệp chỉ dựa vào nước trời nên thường xảy ra mất mùa, thiếu đói	['Quanh năm', 'sản xuất', 'nông nghiệp', 'chỉ', 'dựa', 'vào', 'nước', 'trời', 'nên', 'thường', 'xảy', 'ra', 'mất mùa', ',', 'thiếu đói']
Vụ hè thu năm nay, hàng trăm hecta lúa gieo gần như mất sạch	['Vụ', 'hè thu', 'năm', 'nay', ',', 'hàng', 'trăm', 'hecta', 'lúa gieo', 'gần', 'như', 'mất', 'sạch']
Anh Trương Anh Đào, cán bộ địa chính xã gieo 2ha phải bỏ đi 1ha vì thiếu nước; còn 1ha không thu hoạch được vì cỏ nhiều hơn lúa, phải cho trâu vào ăn để khỏi tốn chi phí cắt bỏ! Cụ bà Thái Thị Lợt, 80 tuổi ở thôn Vinh Đông, xã Bình Trị gieo 4 sào ( 2	['Anh', 'Trương Anh Đào', ',', 'cán bộ', 'địa chính', 'xã', 'gieo', '2ha', 'phải', 'bỏ', 'đi', '1ha', 'vì', 'thiếu', 'nước', ';', 'còn', '1ha', 'không', 'thu hoạch', 'được', 'vì', 'cỏ', 'nhiều', 'hơn', 'lúa', ',', 'phải', 'cho', 'trâu', 'vào', 'ăn', 'để', 'khỏi', 'tốn', 'chi phí', 'cắt', 'bỏ', '!', 'Cụ bà', 'Thái Thị Lợt', ',', '80', 'tuổi', 'ở', 'thôn', 'Vinh Đông', ',', 'xã', 'Bình Trị', 'gieo', '4', 'sào', '(', '2']
000 mét vuông) chỉ thu hoạch được khoảng 90 ký lúa, nhưng phải mất 40 ngàn tiền thuê người gặt! Năng suất lúa bình quân của 2 xã này là 15 tạ/ha khi mưa thuận gió hòa và chỉ còn 5-6 tạ/ha năm khô hạn	['000', 'mét vuông', ')', 'chỉ', 'thu hoạch', 'được', 'khoảng', '90', 'ký', 'lúa', ',', 'nhưng', 'phải', 'mất', '40', 'ngàn', 'tiền', 'thuê', 'người', 'gặt', '!', 'Năng suất', 'lúa', 'bình quân', 'của', '2', 'xã', 'này', 'là', '15', 'tạ', '/', 'ha', 'khi', 'mưa', 'thuận gió', 'hòa', 'và', 'chỉ', 'còn', '5-6', 'tạ', '/', 'ha', 'năm', 'khô', 'hạn']
Nguồn nước sinh hoạt được mô tả: Phần lớn nước suối ô nhiễm cyanua ở các điểm khai thác vàng xung quanh nên không dùng được, kể cả tắm giặt vì ngứa và gây ghẻ lở	['Nguồn', 'nước', 'sinh hoạt', 'được', 'mô tả', ':', 'Phần lớn', 'nước', 'suối', 'ô nhiễm', 'cyanua', 'ở', 'các', 'điểm', 'khai thác', 'vàng', 'xung quanh', 'nên', 'không', 'dùng', 'được', ',', 'kể cả', 'tắm giặt', 'vì', 'ngứa', 'và', 'gây', 'ghẻ lở']
Giếng nước phải đào sâu đến 15-16 mét nhưng vẫn khô kiệt vào mùa hè	['Giếng', 'nước', 'phải', 'đào sâu', 'đến', '15-16', 'mét', 'nhưng', 'vẫn', 'khô', 'kiệt', 'vào', 'mùa', 'hè']
Ruộng đồng thất bát, đời sống khó khăn nên trai trẻ phải đi tìm việc ở các thành phố; một số lên rừng đào đãi vàng về phụ giúp gia đình	['Ruộng đồng', 'thất bát', ',', 'đời sống', 'khó khăn', 'nên', 'trai trẻ', 'phải', 'đi', 'tìm', 'việc', 'ở', 'các', 'thành phố', ';', 'một số', 'lên', 'rừng', 'đào', 'đãi', 'vàng', 'về', 'phụ giúp', 'gia đình']
Chủ tịch xã Bình Trị, Nguyễn Văn Diên cho biết, tệ nạn ở các bãi vàng đem lại hậu quả là toàn xã đã có 28 thanh niên nhiễm HIV và 14 người trong số đó đã chết! Chuyện này gây ra một cú sốc lớn với người dân địa phương!	['Chủ tịch', 'xã', 'Bình Trị', ',', 'Nguyễn Văn Diên', 'cho', 'biết', ',', 'tệ nạn', 'ở', 'các', 'bãi', 'vàng', 'đem', 'lại', 'hậu quả', 'là', 'toàn', 'xã', 'đã', 'có', '28', 'thanh niên', 'nhiễm', 'HIV', 'và', '14', 'người', 'trong', 'số', 'đó', 'đã', 'chết', '!', 'Chuyện', 'này', 'gây', 'ra', 'một', 'cú', 'sốc', 'lớn', 'với', 'người', 'dân', 'địa phương', '!']
Do giao thông không thuận lợi, việc đi lại của người dân cũng rất khó khăn	['Do', 'giao thông', 'không', 'thuận lợi', ',', 'việc', 'đi lại', 'của', 'người', 'dân', 'cũng', 'rất', 'khó khăn']
Học sinh tiểu học ở thôn 6 (Bình Định) hoặc thôn Vinh Nam (Bình Trị) muốn đến lớp phải đi xa đến 3km qua nhiều suối, dốc nguy hiểm vào mùa mưa lũ	['Học sinh', 'tiểu học', 'ở', 'thôn', '6', '(', 'Bình Định', ')', 'hoặc', 'thôn', 'Vinh Nam', '(', 'Bình Trị', ')', 'muốn', 'đến', 'lớp', 'phải', 'đi', 'xa', 'đến', '3km', 'qua', 'nhiều', 'suối', ',', 'dốc', 'nguy hiểm', 'vào', 'mùa', 'mưa lũ']
Không qui hoạch được dân cư và giao thông vì phải chờ	['Không', 'qui hoạch', 'được', 'dân cư', 'và', 'giao thông', 'vì', 'phải', 'chờ']
Quy hoạch thủy lợi vùng Tây Thăng Bình từ sau ngày giải phóng đã xác định 2 hồ chứa Cao Ngạn và Đông Tiển sẽ góp phần cắt lũ ở hạ lưu và giải quyết nước tưới cho trên 3	['Quy hoạch', 'thủy lợi', 'vùng', 'Tây', 'Thăng Bình', 'từ', 'sau', 'ngày', 'giải phóng', 'đã', 'xác định', '2', 'hồ', 'chứa', 'Cao Ngạn', 'và', 'Đông Tiển', 'sẽ', 'góp phần', 'cắt', 'lũ', 'ở', 'hạ lưu', 'và', 'giải quyết', 'nước', 'tưới', 'cho', 'trên', '3']
Riêng hồ chứa Đông Tiển với diện tích mặt hồ rộng 8 km vuông, chứa khoảng 6 triệu mét khối nước và hệ thống kênh dẫn sẽ tưới cho trên 730 ha cây trồng và cung cấp nước sinh hoạt cho 15 ngàn dân của 2 xã trên	['Riêng', 'hồ', 'chứa', 'Đông Tiển', 'với', 'diện tích', 'mặt', 'hồ', 'rộng', '8', 'km', 'vuông', ',', 'chứa', 'khoảng', '6', 'triệu', 'mét khối', 'nước', 'và', 'hệ thống kênh', 'dẫn', 'sẽ', 'tưới', 'cho', 'trên', '730', 'ha', 'cây trồng', 'và', 'cung cấp', 'nước', 'sinh hoạt', 'cho', '15', 'ngàn', 'dân', 'của', '2', 'xã', 'trên']
Theo ông Nguyễn Thuyết, Phó chủ tịch UBND huyện Thăng Bình, từ năm 1998 tỉnh Quảng Nam đầu tư 300 triệu cho việc khảo sát thiết kế chuẩn bị đầu tư	['Theo', 'ông', 'Nguyễn Thuyết', ',', 'Phó', 'chủ tịch', 'UBND', 'huyện', 'Thăng Bình', ',', 'từ', 'năm', '1998', 'tỉnh', 'Quảng Nam', 'đầu tư', '300', 'triệu', 'cho', 'việc', 'khảo sát', 'thiết kế', 'chuẩn bị', 'đầu tư']
Tháng 4/2000, dự án nghiên cứu khả thi đã được công ty Tư vấn Xây dựng Thủy Lợi Đà Nẵng hoàn tất	['Tháng', '4/20', '00', ',', 'dự án', 'nghiên cứu', 'khả thi', 'đã', 'được', 'công ty', 'Tư vấn', 'Xây dựng', 'Thủy Lợi', 'Đà Nẵng', 'hoàn tất']
Ngày 6/5/2002, UBND tỉnh giao nhiệm vụ cho huyện lập Ban giải phóng mặt bằng và phương án giải phóng mặt bằng đã được phê duyệt ngày 19/5/2003 với tổng kinh phí 10,63 tỉ đồng theo hướng dẫn và trình tự của Bộ NN&amp;PTNT ngày 7/1/2003	['Ngày', '6/5/2002', ',', 'UBND', 'tỉnh', 'giao', 'nhiệm vụ', 'cho', 'huyện', 'lập', 'Ban', 'giải phóng', 'mặt bằng', 'và', 'phương án', 'giải phóng', 'mặt bằng', 'đã', 'được', 'phê duyệt', 'ngày', '19/5/2003', 'với', 'tổng', 'kinh phí', '10,63', 'tỉ', 'đồng', 'theo', 'hướng dẫn', 'và', 'trình tự', 'của', 'Bộ', 'NN', '&', 'amp', ';', 'PTNT', 'ngày', '7/1/2003']
