<br /><br />I started watching the show in reruns in 2001	[('the show', 'show', 'dobj', 'watching'), ('reruns', 'reruns', 'pobj', 'in')]
<br /><br />I enjoy the show but it had too many faults	[('the show', 'show', 'dobj', 'enjoy'), ('it', 'it', 'nsubj', 'had'), ('too many faults', 'faults', 'dobj', 'had')]
<br /><br />I HATE THE MICHELLE & JOEY CHARACTERS!<br /><br />Stealing story lines from old TV shows	[('HATE', 'HATE', 'ROOT', 'HATE'), ('THE MICHELLE', 'MICHELLE', 'dobj', 'HATE'), ('JOEY CHARACTERS!<br', 'CHARACTERS!<br', 'conj', 'MICHELLE'), ('/>Stealing story lines', 'lines', 'ROOT', 'lines'), ('old TV shows', 'shows', 'pobj', 'from')]
They even stole from "The Partirdge Family	[('They', 'They', 'nsubj', 'stole'), ('The Partirdge Family', 'Family', 'pobj', 'from')]
" Then in 1 episode "The Partridge Family" was mentioned	[('1 episode', 'episode', 'pobj', 'in'), ('The Partridge Family', 'Family', 'nsubjpass', 'mentioned')]
<br /><br />Actors playing different roles in different episodes	[('different roles', 'roles', 'dobj', 'playing'), ('different episodes', 'episodes', 'pobj', 'in')]
MTV Martha Quinn the most notable doing this, especially when she played herself in 1 episode	[('MTV Martha Quinn', 'Quinn', 'ROOT', 'Quinn'), ('she', 'she', 'nsubj', 'played'), ('herself', 'herself', 'dobj', 'played'), ('1 episode', 'episode', 'pobj', 'in')]
<br /><br />The Michelle character COULD NOT take a joke but then they had this little kid act out "revenge" to her sisters for a joke by them on her	[('Michelle character', 'character', 'nsubj', 'take'), ('a joke', 'joke', 'dobj', 'take'), ('they', 'they', 'nsubj', 'had'), ('this little kid act', 'act', 'ROOT', 'act'), ('"revenge', 'revenge', 'dobj', 'act'), ('her sisters', 'sisters', 'pobj', 'to'), ('a joke', 'joke', 'pobj', 'for'), ('them', 'them', 'pobj', 'by'), ('her', 'her', 'pobj', 'on')]
<br /><br />Story lines that came & went in 1 episode	[('<br /><br />Story lines', 'lines', 'ROOT', 'lines'), ('1 episode', 'episode', 'pobj', 'in')]
Joey getting the TV show with Frankie & Annette, never heard from it again after that	[('Joey', 'Joey', 'nsubj', 'getting'), ('the TV show', 'show', 'dobj', 'getting'), ('Frankie', 'Frankie', 'pobj', 'with'), ('Annette', 'Annette', 'conj', 'Frankie'), ('it', 'it', 'pobj', 'from')]
1 episode he is coaching soccer, 1 episode he is coaching softball/baseball	[('he', 'he', 'nsubj', 'coaching'), ('soccer', 'soccer', 'dobj', 'coaching'), ('he', 'he', 'nsubj', 'coaching'), ('softball/baseball', 'baseball', 'dobj', 'coaching')]
1 game & you are out huh Danny? <br /><br />Jesse & Joey keep getting jobs REALLY QUICKLY with no experience	[('1 game', 'game', 'nsubj', 'are'), ('you', 'you', 'conj', 'game'), ('huh Danny', 'Danny', 'attr', 'are'), ('Joey', 'Joey', 'nsubj', 'keep'), ('jobs', 'jobs', 'dobj', 'getting'), ('no experience', 'experience', 'pobj', 'with')]
Wish Jodie Sweetin could have learned from Candace Cameron Bure & had a clean NON drug adult life	[('Wish Jodie Sweetin', 'Sweetin', 'nsubj', 'learned'), ('Candace Cameron Bure', 'Bure', 'pobj', 'from'), ('a clean NON drug adult life', 'life', 'dobj', 'had')]
It is a realistic depiction of rural ranching life which was a big part of American History	[('It', 'It', 'nsubj', 'is'), ('a realistic depiction', 'depiction', 'attr', 'is'), ('rural ranching life', 'life', 'pobj', 'of'), ('a big part', 'part', 'attr', 'was'), ('American History', 'History', 'pobj', 'of')]
The setting is 1906 Wyoming where life had not changed much since the previous century	[('The setting', 'setting', 'nsubj', 'is'), ('Wyoming', 'Wyoming', 'attr', 'is'), ('life', 'life', 'nsubj', 'changed'), ('the previous century', 'century', 'pobj', 'since')]
The film keeps your interest without the added Hollywood myths	[('The film', 'film', 'nsubj', 'keeps'), ('your interest', 'interest', 'dobj', 'keeps'), ('the added Hollywood myths', 'myths', 'pobj', 'without')]
The whole family can see this movie and be intrigued about how life was like in America when it was mostly a rural nation	[('The whole family', 'family', 'nsubj', 'see'), ('this movie', 'movie', 'dobj', 'see'), ('life', 'life', 'nsubj', 'was'), ('America', 'America', 'pobj', 'in'), ('it', 'it', 'nsubj', 'was'), ('a rural nation', 'nation', 'attr', 'was')]
With this film, you will escape the present and witness the daily life of 100 years ago	[('this film', 'film', 'pobj', 'With'), ('you', 'you', 'nsubj', 'escape'), ('the present', 'present', 'dobj', 'escape'), ('the daily life', 'life', 'dobj', 'witness')]
In a beautiful, scenic environment you will see the hard physical work that was required to survive, as well as the constant worries and concerns of the elements and the market pressures that will make a difference between success or failure	[('a beautiful, scenic environment', 'environment', 'pobj', 'In'), ('you', 'you', 'nsubj', 'see'), ('the hard physical work', 'work', 'dobj', 'see'), ('the elements', 'elements', 'pobj', 'of'), ('the market pressures', 'pressures', 'conj', 'elements'), ('a difference', 'difference', 'dobj', 'make'), ('success', 'success', 'pobj', 'between'), ('failure', 'failure', 'conj', 'success')]
See this movie and experience life as it was for most of our nation's history	[('this movie', 'movie', 'dobj', 'See'), ('experience', 'experience', 'conj', 'See'), ('life', 'life', 'dobj', 'experience'), ('it', 'it', 'nsubj', 'was'), ("our nation's history", 'history', 'pobj', 'of')]
My only question is - why aren't there more films like this one	[('My only question', 'question', 'nsubj', 'is'), ('more films', 'films', 'attr', 'are'), ('this one', 'one', 'pobj', 'like')]
If you are viewing this show for the first time, you may start wondering if you are in an alternate reality	[('you', 'you', 'nsubj', 'viewing'), ('this show', 'show', 'dobj', 'viewing'), ('the first time', 'time', 'pobj', 'for'), ('you', 'you', 'nsubj', 'start'), ('you', 'you', 'nsubj', 'are'), ('an alternate reality', 'reality', 'pobj', 'in')]
Colorful and imaginative characters? Entertaining dialogue? Plots that seem to have some depth to them, even creating atmospheres of suspense and drama at times? I mean, this is a syndicated children's show right? This is the same venue that has brought kids such drek as "Pokemon", "Pepper Ann", "Mighty Morphin Power Rangers", and "VR Troopers" (please note that three of the titles mentioned above are crass Japanese exports, courtesy of the Fox Network and Saban Entertainment)	[('Colorful and imaginative characters', 'characters', 'ROOT', 'characters'), ('Entertaining dialogue', 'dialogue', 'ROOT', 'dialogue'), ('Plots', 'Plots', 'ROOT', 'Plots'), ('some depth', 'depth', 'dobj', 'have'), ('them', 'them', 'pobj', 'to'), ('atmospheres', 'atmospheres', 'dobj', 'creating'), ('suspense', 'suspense', 'pobj', 'of'), ('drama', 'drama', 'conj', 'suspense'), ('times', 'times', 'pobj', 'at'), ('I', 'I', 'nsubj', 'mean'), ("a syndicated children's show", 'show', 'attr', 'is'), ('the same venue', 'venue', 'attr', 'is'), ('kids', 'kids', 'dobj', 'brought'), ('Pokemon', 'Pokemon', 'pobj', 'as'), ('"Pepper Ann', 'Ann', 'appos', 'This'), ('Mighty Morphin Power Rangers', 'Rangers', 'appos', 'Ann'), ('"VR Troopers', 'Troopers', 'conj', 'Ann'), ('the titles', 'titles', 'pobj', 'of'), ('crass Japanese exports', 'exports', 'attr', 'are'), ('courtesy', 'courtesy', 'conj', 'exports'), ('the Fox Network', 'Network', 'pobj', 'of'), ('Saban Entertainment', 'Entertainment', 'conj', 'Network')]
Don't worry, you are just sampling some of the quality fare that was available to kids during the late 1980's and early 1990's	[('you', 'you', 'nsubj', 'sampling'), ('the quality fare', 'fare', 'pobj', 'of'), ('kids', 'kids', 'pobj', 'to')]
Some examples of this period would be "Transformers", "Garfield and Friends", "Captain Power", and "C	[('Some examples', 'examples', 'nsubj', 'be'), ('this period', 'period', 'pobj', 'of'), ('"Transformers', 'Transformers', 'attr', 'be'), ('Garfield', 'Garfield', 'appos', 'Transformers'), ('Friends', 'Friends', 'conj', 'Garfield'), ('Captain Power', 'Power', 'appos', 'Transformers'), ('"C', 'C', 'conj', 'Power')]
" (a cartoon NOT to be confused with the live action show on Fox)	[('" (a cartoon', 'cartoon', 'ROOT', 'cartoon'), ('the live action show', 'show', 'pobj', 'with'), ('Fox', 'Fox', 'pobj', 'on')]
Besides these prime examples, Disney also returned to syndicated programs for kids, coming up with a lineup called "The Disney Afternoon"	[('these prime examples', 'examples', 'pobj', 'Besides'), ('Disney', 'Disney', 'nsubj', 'returned'), ('syndicated programs', 'programs', 'pobj', 'to'), ('kids', 'kids', 'pobj', 'for'), ('a lineup', 'lineup', 'pobj', 'with')]
Aside from a dumbed-down show called "The Gummi Bears", early shows like "Darkwing Duck", "Duck Tales", and "Chip 'N Dale's Rescue Rangers" gave credence to the Disney animation teams that were also turning out theatrical classics like "The Little Mermaid", "Beauty and the Beast", "The Rescuers Down Under", and "The Great Mouse Detective"	[('a dumbed-down show', 'show', 'pobj', 'from'), ('Duck', 'Duck', 'dobj', 'Darkwing'), ('"Duck Tales', 'Tales', 'pobj', 'like'), ('"Chip \'N Dale\'s Rescue Rangers', 'Rangers', 'conj', 'Tales'), ('credence', 'credence', 'dobj', 'gave'), ('the Disney animation teams', 'teams', 'pobj', 'to'), ('theatrical classics', 'classics', 'dobj', 'turning'), ('"The Little Mermaid', 'Mermaid', 'pobj', 'like'), ('Beauty', 'Beauty', 'conj', 'Mermaid'), ('the Beast', 'Beast', 'conj', 'Beauty'), ('The Rescuers', 'Rescuers', 'appos', 'Mermaid'), ('"The Great Mouse Detective', 'Detective', 'conj', 'Rescuers')]
But above all these wonders shines "TaleSpin"	[('all these wonders', 'wonders', 'nsubj', 'shines'), ('TaleSpin', 'TaleSpin', 'dobj', 'shines')]
The premiere of "Plunder and Lightning" was a two-hour thrill ride, and won an Emmy	[('The premiere', 'premiere', 'nsubj', 'was'), ('Plunder', 'Plunder', 'pobj', 'of'), ('Lightning', 'Lightning', 'conj', 'Plunder'), ('a two-hour thrill ride', 'ride', 'attr', 'was'), ('an Emmy', 'Emmy', 'dobj', 'won')]
Much to my delight, the rest of the episodes were up to par on the promise of the premiere	[('my delight', 'delight', 'pobj', 'to'), ('the rest', 'rest', 'nsubj', 'were'), ('the episodes', 'episodes', 'pobj', 'of'), ('par', 'par', 'pobj', 'to'), ('the promise', 'promise', 'pobj', 'on'), ('the premiere', 'premiere', 'pobj', 'of')]
<br /><br />While I enjoy the plots and dialogue, I guess for me the greatest attraction are the characters	[('I', 'I', 'nsubj', 'enjoy'), ('the plots', 'plots', 'dobj', 'enjoy'), ('dialogue', 'dialogue', 'conj', 'plots'), ('I', 'I', 'nsubj', 'guess'), ('me', 'me', 'pobj', 'for'), ('the greatest attraction', 'attraction', 'nsubj', 'are'), ('the characters', 'characters', 'attr', 'are')]
There's Rebecca Cunningham, an independent female, but still fallible; Kit Cloudkicker, full of pre-teen angst and optimism; Louie, with his loyalty and support; Frank Wildcat, the most entertaining engineer since Scotty on the original "Star Trek"; Molly Cunningham, cute and witty, but with some depth that most child characters don't have, and of course in the middle of it all, there's Baloo, whom I would describe as a slobby version of James Bond	[('Rebecca Cunningham', 'Cunningham', 'attr', "'s"), ('an independent female', 'female', 'appos', 'Cunningham'), ('Kit Cloudkicker', 'Cloudkicker', 'appos', 'Cunningham'), ('pre-teen angst', 'angst', 'pobj', 'of'), ('optimism', 'optimism', 'conj', 'angst'), ('Louie', 'Louie', 'appos', 'Cunningham'), ('his loyalty', 'loyalty', 'pobj', 'with'), ('support', 'support', 'conj', 'loyalty'), ('Frank Wildcat', 'Wildcat', 'conj', 'Cunningham'), ('the most entertaining engineer', 'engineer', 'appos', 'Wildcat'), ('Scotty', 'Scotty', 'pobj', 'since'), ('the original "Star Trek', 'Trek', 'pobj', 'on'), ('Molly Cunningham', 'Cunningham', 'conj', 'Wildcat'), ('some depth', 'depth', 'pobj', 'with'), ('most child characters', 'characters', 'nsubj', 'have'), ('course', 'course', 'pobj', 'of'), ('the middle', 'middle', 'pobj', 'in'), ('it', 'it', 'pobj', 'of'), ('Baloo', 'Baloo', 'attr', "'s"), ('whom', 'whom', 'dobj', 'describe'), ('I', 'I', 'nsubj', 'describe'), ('a slobby version', 'version', 'pobj', 'as'), ('James Bond', 'Bond', 'pobj', 'of')]
This is because whenever there's trouble, Baloo saves the day with the assistance of his sleeker-than-most, fastest-of-all Sea Duck (Read: James Bond's Aston Martin)	[('trouble', 'trouble', 'attr', "'s"), ('Baloo', 'Baloo', 'nsubj', 'saves'), ('the day', 'day', 'dobj', 'saves'), ('the assistance', 'assistance', 'pobj', 'with'), ('his sleeker-than-most, fastest-of-all Sea Duck', 'Duck', 'pobj', 'of'), ("James Bond's Aston Martin", 'Martin', 'ROOT', 'Martin')]
Of course every great show has to have great villains, and TaleSpin doesn't disappoint here either	[('every great show', 'show', 'nsubj', 'has'), ('great villains', 'villains', 'dobj', 'have'), ('TaleSpin', 'TaleSpin', 'nsubj', 'disappoint')]
From the megalomania of businesstiger Shere Kahn, to the vain and always failing air pirate Don Karnage, to the hilarious and inept Soviet-satirized Thembrians	[('the megalomania', 'megalomania', 'pobj', 'From'), ('businesstiger Shere Kahn', 'Kahn', 'pobj', 'of'), ('air pirate Don Karnage', 'Karnage', 'pobj', 'to'), ('the hilarious and inept Soviet-satirized Thembrians', 'Thembrians', 'pobj', 'to')]
The animation is good, the music appropriate, and the episodes are (for me) the finest that children's programming has ever had to offer	[('The animation', 'animation', 'nsubj', 'is'), ('the music', 'music', 'nsubj', 'appropriate'), ('the episodes', 'episodes', 'nsubj', 'are'), ('me', 'me', 'pobj', 'for'), ("children's programming", 'programming', 'nsubj', 'had')]
As did others in this forum, when "Fobidden Planet" was offered in 1956, I rushed to see it	[('others', 'others', 'nsubj', 'did'), ('this forum', 'forum', 'pobj', 'in'), ('Fobidden Planet', 'Planet', 'nsubjpass', 'offered'), ('I', 'I', 'nsubj', 'rushed'), ('it', 'it', 'dobj', 'see')]
This story is an interesting phenomenon I suggest because young, old, male, female, sci-fi experts and people who find such fare 'way out" all can follow and enjoy this film's story and plot lines very well	[('This story', 'story', 'nsubj', 'is'), ('an interesting phenomenon', 'phenomenon', 'attr', 'is'), ('I', 'I', 'nsubj', 'suggest'), ('young, old, male, female, sci-fi experts', 'experts', 'nsubj', 'follow'), ('people', 'people', 'conj', 'experts'), ('who', 'who', 'nsubj', 'find'), ("such fare 'way", 'way', 'dobj', 'find'), ("this film's story and plot lines", 'lines', 'dobj', 'enjoy')]
This is the first movie set on a planet other than Earth in the 20th Century other than serials such as "Flash Gordon"	[('the first movie', 'movie', 'attr', 'is'), ('a planet', 'planet', 'pobj', 'on'), ('Earth', 'Earth', 'pobj', 'than'), ('the 20th Century', 'Century', 'pobj', 'in'), ('serials', 'serials', 'pobj', 'than'), ('"Flash Gordon', 'Gordon', 'pobj', 'as')]
Leslie Nielsen was vocally a bit weak for his role, at that time, but Walter Pigeon, Marvin Miller, Anne Francis, Richard Anderson, Earl Holliman and especially Warren Stevens all acquitted themselves very well	[('Leslie Nielsen', 'Nielsen', 'nsubj', 'was'), ('his role', 'role', 'pobj', 'for'), ('that time', 'time', 'pobj', 'at'), ('Walter Pigeon', 'Pigeon', 'nsubj', 'acquitted'), ('Marvin Miller', 'Miller', 'appos', 'Pigeon'), ('Anne Francis', 'Francis', 'conj', 'Miller'), ('Richard Anderson', 'Anderson', 'conj', 'Francis'), ('Earl Holliman', 'Holliman', 'conj', 'Anderson'), ('especially Warren Stevens', 'Stevens', 'conj', 'Holliman'), ('themselves', 'themselves', 'dobj', 'acquitted')]
There are so many visual splendors in this one, it's hard to choose a favorite from the film's scenes	[('so many visual splendors', 'splendors', 'attr', 'are'), ('this one', 'one', 'pobj', 'in'), ('it', 'it', 'nsubj', "'s"), ('a favorite', 'favorite', 'dobj', 'choose'), ("the film's scenes", 'scenes', 'pobj', 'from')]
The approach to Altair-4, the starship itself, the landing on the planet's alien surface, the descent via extensor stairs, the first view of the landscape, the approach of the rocket-sled, Dr	[('The approach', 'approach', 'ROOT', 'approach'), ('Altair-4', 'Altair-4', 'pobj', 'to'), ('the starship', 'starship', 'appos', 'Altair-4'), ('itself', 'itself', 'appos', 'starship'), ('the landing', 'landing', 'appos', 'approach'), ("the planet's alien surface", 'surface', 'pobj', 'on'), ('the descent', 'descent', 'conj', 'landing'), ('extensor stairs', 'stairs', 'pobj', 'via'), ('the first view', 'view', 'appos', 'approach'), ('the landscape', 'landscape', 'pobj', 'of'), ('the approach', 'approach', 'appos', 'view'), ('Dr', 'Dr', 'pobj', ',')]
Morbius's house seen from without and from within, the underground complex and its wonders, the setup of the weaponry, the battle with the monster, the final approach of the unseen destroyer,the escape from the doomed planet--all these scenes are etched into the viewer's mind because we discover them along with the participants	[("Morbius's house", 'house', 'nsubj', 'seen'), ('the underground complex', 'complex', 'nsubjpass', 'etched'), ('its wonders', 'wonders', 'conj', 'complex'), ('the setup', 'setup', 'appos', 'complex'), ('the weaponry', 'weaponry', 'pobj', 'of'), ('the battle', 'battle', 'appos', 'complex'), ('the monster', 'monster', 'pobj', 'with'), ('the final approach', 'approach', 'appos', 'monster'), ('the unseen destroyer', 'destroyer', 'pobj', 'of'), ('the escape', 'escape', 'conj', 'complex'), ('the doomed planet', 'planet', 'pobj', 'from'), ('all these scenes', 'scenes', 'nsubjpass', 'etched'), ("the viewer's mind", 'mind', 'pobj', 'into'), ('we', 'we', 'nsubj', 'discover'), ('them', 'them', 'dobj', 'discover'), ('the participants', 'participants', 'pobj', 'with')]
Veteran Cyril Hume's literate script was filmed intelligently by long-time director Fred McLeod Wilcox with clarity and imagination	[("Veteran Cyril Hume's literate script", 'script', 'nsubjpass', 'filmed'), ('long-time director Fred McLeod Wilcox', 'Wilcox', 'pobj', 'by'), ('clarity', 'clarity', 'pobj', 'with'), ('imagination', 'imagination', 'conj', 'clarity')]
it is a shock to realize there's no music at all; the film is carried by the words, the actors and the mystery-revelation storyline	[('it', 'it', 'nsubj', 'is'), ('a shock', 'shock', 'attr', 'is'), ('no music', 'music', 'attr', "'s"), ('the film', 'film', 'nsubjpass', 'carried'), ('the words', 'words', 'pobj', 'by'), ('the actors', 'actors', 'conj', 'words'), ('the mystery-revelation storyline', 'storyline', 'conj', 'actors')]
It can be watched again and again with pleasure--I have been doing so for nearly fifty years	[('It', 'It', 'nsubjpass', 'watched'), ('pleasure', 'pleasure', 'pobj', 'with'), ('I', 'I', 'nsubj', 'doing'), ('nearly fifty years', 'years', 'pobj', 'for')]
Until this famous and well-loved film was created, no film had tried to imagine a world beyond Earth; and for decades afterward, ships kept crashing back on the planet--as if the writers' imaginations were failing and causing the crashes	[('this famous and well-loved film', 'film', 'nsubjpass', 'created'), ('no film', 'film', 'nsubj', 'tried'), ('a world', 'world', 'dobj', 'imagine'), ('Earth', 'Earth', 'pobj', 'beyond'), ('decades', 'decades', 'pobj', 'for'), ('ships', 'ships', 'nsubj', 'kept'), ('the planet', 'planet', 'pobj', 'on'), ("the writers' imaginations", 'imaginations', 'nsubj', 'failing'), ('the crashes', 'crashes', 'dobj', 'causing')]
That says something negative about this nation's so-called intellectual leaders' imaginations--and something very positive indeed I suggest about those who made this gem	[('something', 'something', 'dobj', 'says'), ("this nation's so-called intellectual leaders' imaginations", 'imaginations', 'pobj', 'about'), ('something', 'something', 'conj', 'says'), ('I', 'I', 'nsubj', 'suggest'), ('who', 'who', 'nsubj', 'made'), ('this gem', 'gem', 'dobj', 'made')]
The funky, yet strictly second-tier British glam-rock band Strange Fruit breaks up at the end of the wild'n'wacky excess-ridden 70's	[('The funky, yet strictly second-tier British glam-rock band Strange Fruit', 'Fruit', 'nsubj', 'breaks'), ('the end', 'end', 'pobj', 'at')]
The individual band members go their separate ways and uncomfortably settle into lackluster middle age in the dull and uneventful 90's: morose keyboardist Stephen Rea winds up penniless and down on his luck, vain, neurotic, pretentious lead singer Bill Nighy tries (and fails) to pursue a floundering solo career, paranoid drummer Timothy Spall resides in obscurity on a remote farm so he can avoid paying a hefty back taxes debt, and surly bass player Jimmy Nail installs roofs for a living	[('The individual band members', 'members', 'nsubj', 'go'), ('their separate ways', 'ways', 'dobj', 'go'), ('lackluster middle age', 'age', 'pobj', 'into'), ('morose keyboardist Stephen Rea', 'Rea', 'nsubj', 'winds'), ('his luck', 'luck', 'pobj', 'on'), ('vain, neurotic, pretentious lead singer Bill Nighy', 'Nighy', 'nsubj', 'tries'), ('a floundering solo career', 'career', 'dobj', 'pursue'), ('paranoid drummer Timothy Spall', 'Spall', 'nsubj', 'resides'), ('obscurity', 'obscurity', 'pobj', 'in'), ('a remote farm', 'farm', 'pobj', 'on'), ('he', 'he', 'nsubj', 'avoid'), ('a hefty back taxes debt', 'debt', 'dobj', 'paying'), ('surly bass player Jimmy Nail installs roofs', 'roofs', 'ROOT', 'roofs'), ('a living', 'living', 'pobj', 'for')]
Former loving groupie turned patient, understanding, long-suffering manager Juliet Aubrey gets the group back together for an ill-advised, largely ineffectual and hilariously disastrous twenty years later nostalgic reunion tour of Europe	[('Former loving groupie', 'groupie', 'nsubj', 'turned'), ('long-suffering manager Juliet Aubrey', 'Aubrey', 'nsubj', 'gets'), ('the group', 'group', 'dobj', 'gets'), ('an ill-advised, largely ineffectual and hilariously disastrous twenty years later nostalgic reunion tour', 'tour', 'pobj', 'for'), ('Europe', 'Europe', 'pobj', 'of')]
Our lovably ragged bunch try gamely, but fumblingly to reignite a flame that once burned quite brightly back in the day	[('Our lovably ragged bunch', 'bunch', 'nsubj', 'try'), ('a flame', 'flame', 'dobj', 'reignite'), ('the day', 'day', 'pobj', 'in')]
Scraggly zonked-out roadie Billy Connelly and cocky eager beaver young guitarist Hans Matheson tag along for the delightfully bumpy, trouble-plagued, but still ultimately rewarding and enjoyable ride	[('Scraggly zonked-out roadie', 'roadie', 'ROOT', 'roadie'), ('cocky eager beaver young guitarist Hans Matheson', 'Matheson', 'nsubj', 'tag'), ('ride', 'ride', 'pobj', 'for')]
<br /><br />Director Brian Gibson shows tremendously infectious respect and adoration for both his amiably screwy characters in particular and loud, ringing, flamboyantly overblown preening 70's rock in general, this imbuing this affectionate little pip with an utterly engaging sense of big-hearted charm and tireless verve	[('Brian Gibson', 'Gibson', 'nsubj', 'shows'), ('tremendously infectious respect', 'respect', 'dobj', 'shows'), ('adoration', 'adoration', 'conj', 'respect'), ('both his amiably screwy characters', 'characters', 'pobj', 'for'), ("70's rock", 'rock', 'dobj', 'preening'), ('this affectionate little pip', 'pip', 'dobj', 'imbuing'), ('an utterly engaging sense', 'sense', 'pobj', 'with'), ('big-hearted charm', 'charm', 'pobj', 'of')]
The astute, sharply written script by Dick Clement and Ian La Frenais likewise bristles with spot-on dry wit and finely observed moments of joyous on the road inanity, capturing a certain bittersweetly affecting and frequently uproarious vibe that gives the picture itself an irresistibly luminescent glow	[('The astute', 'astute', 'nsubj', 'written'), ('Dick Clement', 'Clement', 'pobj', 'by'), ('Ian La Frenais', 'Frenais', 'conj', 'Clement'), ('dry wit', 'wit', 'pobj', 'on'), ('the road inanity', 'inanity', 'pobj', 'on'), ('the picture', 'picture', 'dative', 'gives'), ('itself', 'itself', 'appos', 'picture'), ('an irresistibly luminescent glow', 'glow', 'dobj', 'gives')]
Ashley Rowe's lovely, elegant cinematography ensures that the movie always looks quite visually sumptuous while the perfectly catchy and groovy music does the trick with right-on rockin' flair and aplomb	[('Ashley Rowe', 'Rowe', 'nsubj', 'ensures'), ('elegant cinematography', 'cinematography', 'nsubj', 'ensures'), ('the movie', 'movie', 'nsubj', 'looks'), ('the perfectly catchy and groovy music', 'music', 'nsubj', 'does'), ('the trick', 'trick', 'dobj', 'does'), ("right-on rockin' flair", 'flair', 'pobj', 'with'), ('aplomb', 'aplomb', 'conj', 'flair')]
Kudos also to the across-the-board terrific performances that vividly nail the burnt-out soul and tattered, but still fiercely beating heart of a past its prime has-been ragtag rock outfit desperate to regain its erstwhile evanescent glory in one final bid for big time success	[('Kudos', 'Kudos', 'ROOT', 'Kudos'), ('the-board', 'board', 'pobj', 'across'), ('the burnt-out soul', 'soul', 'dobj', 'nail'), ('heart', 'heart', 'dobj', 'beating'), ('its prime', 'prime', 'pobj', 'past'), ('its erstwhile evanescent glory', 'glory', 'dobj', 'regain'), ('one final bid', 'bid', 'pobj', 'in'), ('big time success', 'success', 'pobj', 'for')]
All in all, this radiant and touching gem rates highly as one of the true seriocomic sleeper treats from the 90's	[('All in all, this radiant and touching gem rates', 'rates', 'ROOT', 'rates')]
I work at a movie store, and as such, I am always on the look-out for an excellent movie	[('I', 'I', 'nsubj', 'work'), ('a movie store', 'store', 'pobj', 'at'), ('I', 'I', 'nsubj', 'am'), ('the look-out', 'out', 'pobj', 'on'), ('an excellent movie', 'movie', 'pobj', 'for')]
I decided to check out Nothing as it sat in our Canadian section, and I've been trying to support my country's movie industry	[('I', 'I', 'nsubj', 'decided'), ('Nothing', 'Nothing', 'dobj', 'check'), ('it', 'it', 'nsubj', 'sat'), ('our Canadian section', 'section', 'pobj', 'in'), ('I', 'I', 'nsubj', 'trying'), ("my country's movie industry", 'industry', 'dobj', 'support')]
The film features David Hewlett and Andrew Miller in a highly entertaining story that seems to delve into so much of our minds and relationships	[('The film', 'film', 'nsubj', 'features'), ('David Hewlett', 'Hewlett', 'dobj', 'features'), ('Andrew Miller', 'Miller', 'conj', 'Hewlett'), ('a highly entertaining story', 'story', 'pobj', 'in'), ('our minds', 'minds', 'pobj', 'of'), ('relationships', 'relationships', 'conj', 'minds')]
It is consistently comedic through the interaction of the two characters, as well as some funny exchanges ("We can't be dead, we have cable!")	[('It', 'It', 'nsubj', 'is'), ('the interaction', 'interaction', 'pobj', 'through'), ('the two characters', 'characters', 'pobj', 'of'), ('some funny exchanges', 'exchanges', 'attr', 'is'), ('We', 'We', 'nsubj', 'be'), ('we', 'we', 'nsubj', 'have'), ('cable', 'cable', 'dobj', 'have')]
What more can I say without noting that it is worth a shot, even if you abandon it within the first half an hour	[('I', 'I', 'nsubj', 'say'), ('it', 'it', 'nsubj', 'is'), ('you', 'you', 'nsubj', 'abandon'), ('it', 'it', 'dobj', 'abandon'), ('the first half an hour', 'hour', 'pobj', 'within')]
Dominion tank police is an exercise in contradictive film making	[('Dominion tank police', 'police', 'nsubj', 'is'), ('an exercise', 'exercise', 'attr', 'is'), ('contradictive film making', 'making', 'pobj', 'in')]
The storyline across the 4 parts blends mindless action, slap-stick humor, touching humanity and thought provoking philosophical questions	[('The storyline', 'storyline', 'nsubj', 'blends'), ('the 4 parts', 'parts', 'pobj', 'across'), ('mindless action', 'action', 'dobj', 'blends'), ('slap-stick humor', 'humor', 'appos', 'action'), ('humanity', 'humanity', 'dobj', 'touching'), ('philosophical questions', 'questions', 'dobj', 'provoking')]
It's hard to believe that there was only one director, as the style changes from episode to episode	[('It', 'It', 'nsubj', "'s"), ('only one director', 'director', 'attr', 'was'), ('the style', 'style', 'nsubj', 'changes'), ('episode', 'episode', 'pobj', 'from')]
A must-see movie for anyone who likes anime	[('A must-see movie', 'movie', 'ROOT', 'movie'), ('anyone', 'anyone', 'pobj', 'for'), ('who', 'who', 'nsubj', 'likes'), ('anime', 'anime', 'dobj', 'likes')]
enjoyed the movie and efficient Confucian crime drama, the old order survives the threat posed by a brash young greedy man, no doubt representing modern society	[('the movie', 'movie', 'dobj', 'enjoyed'), ('Confucian crime drama', 'drama', 'conj', 'movie'), ('the old order', 'order', 'nsubj', 'survives'), ('the threat', 'threat', 'dobj', 'survives'), ('a brash young greedy man', 'man', 'pobj', 'by'), ('modern society', 'society', 'dobj', 'representing')]
I thought the final scene was strange and could not understand if we were to believe that big D was being punished for being greedy or it was part of the plan a long	[('I', 'I', 'nsubj', 'thought'), ('the final scene', 'scene', 'nsubj', 'was'), ('we', 'we', 'nsubj', 'were'), ('big D', 'D', 'nsubjpass', 'punished'), ('it', 'it', 'nsubj', 'was'), ('part', 'part', 'attr', 'was'), ('the plan', 'plan', 'pobj', 'of')]
I loved the scene and for once in a Chinese movie, the violence was not a choreographed martial arts fest	[('I', 'I', 'nsubj', 'loved'), ('the scene', 'scene', 'dobj', 'loved'), ('a Chinese movie', 'movie', 'pobj', 'in'), ('the violence', 'violence', 'nsubj', 'was')]
On thing that always amuses me about HK films is that the main influence the British seem to have had is to introduce 'yes sir' and 'sorry' into the local language and its amusing that long after we have gone, they are still there	[('thing', 'thing', 'pobj', 'On'), ('me', 'me', 'dobj', 'amuses'), ('HK films', 'films', 'pobj', 'about'), ('the main influence', 'influence', 'nsubj', 'seem'), ('the British', 'British', 'nsubj', 'seem'), ('the local language', 'language', 'pobj', 'into'), ('we', 'we', 'nsubj', 'gone'), ('they', 'they', 'nsubj', 'are')]
At the time I recall being quite startled and amused by this movie	[('the time', 'time', 'pobj', 'At'), ('I', 'I', 'nsubj', 'recall'), ('this movie', 'movie', 'pobj', 'by')]
I referred to it as the most important movie I'd seen in ten years, and found myself bumping into people who said similar things	[('I', 'I', 'nsubj', 'referred'), ('it', 'it', 'pobj', 'to'), ('the most important movie', 'movie', 'pobj', 'as'), ('I', 'I', 'nsubj', 'seen'), ('ten years', 'years', 'pobj', 'in'), ('myself', 'myself', 'nsubj', 'bumping'), ('people', 'people', 'pobj', 'into'), ('who', 'who', 'nsubj', 'said'), ('similar things', 'things', 'dobj', 'said')]
<br /><br />Bernhard has an unusually perceptive behavioral notebook	[('br', 'br', 'nsubj', 'has'), ('an unusually perceptive behavioral notebook', 'notebook', 'dobj', 'has')]
And she has shaped the bitter adolescent personality that we all had, into a corrosive, adult world-view	[('she', 'she', 'nsubj', 'shaped'), ('the bitter adolescent personality', 'personality', 'dobj', 'shaped'), ('we', 'we', 'nsubj', 'had'), ('a corrosive, adult world-view', 'view', 'pobj', 'into')]
The two together provide a startling mix which may be too edgy for some viewers	[('a startling mix', 'mix', 'dobj', 'provide'), ('some viewers', 'viewers', 'pobj', 'for')]
I wish you weren't my brother so I could **** you!) <br /><br />Bernhards search for herself after returning to LA from New York, results in the immersive trying-on of various personas (all of which fit poorly) for our amusement, but enough of them involve acting out to appeal to a "black imperative" values system that the real barometer of her resituation is whether black culture accepts her	[('I', 'I', 'nsubj', 'wish'), ('you', 'you', 'nsubj', 'were'), ('my brother', 'brother', 'attr', 'were'), ('I', 'I', 'nsubj', 'could'), ('**** you', 'you', 'ROOT', 'you'), ('herself', 'herself', 'pobj', 'for'), ('LA', 'LA', 'pobj', 'to'), ('New York', 'York', 'pobj', 'from'), ('various personas', 'personas', 'pobj', 'of'), ('our amusement', 'amusement', 'pobj', 'for'), ('them', 'them', 'pobj', 'of'), ('a "black imperative" values system', 'system', 'pobj', 'to'), ('the real barometer', 'barometer', 'nsubj', 'is'), ('her resituation', 'resituation', 'pobj', 'of'), ('black culture', 'culture', 'nsubj', 'accepts'), ('her', 'her', 'dobj', 'accepts')]
And she has an impressive, solidly-built black lover in the movie) A pretty black girl attends the shows, and seems to be authorizing Sandra's faux-blackness, but ultimately rejects her	[('she', 'she', 'nsubj', 'has'), ('an impressive, solidly-built black lover', 'lover', 'dobj', 'has'), ('the movie', 'movie', 'pobj', 'in'), ('A pretty black girl', 'girl', 'nsubj', 'attends'), ('the shows', 'shows', 'dobj', 'attends'), ("Sandra's faux-blackness", 'blackness', 'dobj', 'authorizing'), ('her', 'her', 'dobj', 'rejects')]
<br /><br />Just as Catholics deem themselves lucky to suffer for Christ, here Sandra depicts herself suffering at the hands of a black culture in which she craves a place; as if she cherishes her worthiness and her rejection	[('Catholics', 'Catholics', 'nsubj', 'deem'), ('themselves', 'themselves', 'dobj', 'deem'), ('Christ', 'Christ', 'pobj', 'for'), ('Sandra', 'Sandra', 'nsubj', 'depicts'), ('herself', 'herself', 'dobj', 'depicts'), ('the hands', 'hands', 'pobj', 'at'), ('a black culture', 'culture', 'pobj', 'of'), ('she', 'she', 'nsubj', 'craves'), ('a place', 'place', 'dobj', 'craves'), ('she', 'she', 'nsubj', 'cherishes'), ('her worthiness', 'worthiness', 'dobj', 'cherishes'), ('her rejection', 'rejection', 'conj', 'worthiness')]
It's the only value system implicated in the films world, outside of Bernhards arty confusion	[('It', 'It', 'nsubj', "'s"), ('the only value system', 'system', 'attr', "'s"), ('the films world', 'world', 'pobj', 'in'), ('Bernhards arty confusion', 'confusion', 'pobj', 'of')]
<br /><br />For a nation whose chief issues are racism and money, it's refreshing to see one of the 2 topics dealt with in an atypical way	[('whose chief issues', 'issues', 'nsubj', 'are'), ('racism', 'racism', 'attr', 'are'), ('money', 'money', 'conj', 'racism'), ('it', 'it', 'nsubj', "'s"), ('the 2 topics', 'topics', 'pobj', 'of'), ('an atypical way', 'way', 'pobj', 'in')]
The true measure of any fictional piece of work is whether or not the characters grow from their experiences and emerge from the experience altered in some significant way (note that this change need not be positive or beneficial) at the end	[('The true measure', 'measure', 'nsubj', 'is'), ('any fictional piece', 'piece', 'pobj', 'of'), ('work', 'work', 'pobj', 'of'), ('the characters', 'characters', 'nsubj', 'grow'), ('their experiences', 'experiences', 'pobj', 'from'), ('the experience', 'experience', 'pobj', 'from'), ('some significant way', 'way', 'pobj', 'in'), ('this change', 'change', 'nsubj', 'be'), ('the end', 'end', 'pobj', 'at')]
<br /><br />By that measure, Enchanted April is a resounding success	[('that measure', 'measure', 'nsubj', 'is'), ('Enchanted April', 'April', 'nsubj', 'is'), ('a resounding success', 'success', 'attr', 'is')]
As a film in general, it succeeds quite well-excellent ensemble cast, well-developed characters you come to care about, wonderful script and beautiful sets and locations	[('a film', 'film', 'pobj', 'As'), ('it', 'it', 'nsubj', 'succeeds'), ('quite well-excellent ensemble cast', 'cast', 'dobj', 'succeeds'), ('well-developed characters', 'characters', 'conj', 'cast'), ('you', 'you', 'nsubj', 'come'), ('wonderful script', 'script', 'pobj', 'about'), ('beautiful sets', 'sets', 'conj', 'script'), ('locations', 'locations', 'conj', 'sets')]
Although all the performances are first-rate, three must be mentioned-Josie Lawrence, Jim Broadbent and Joan Plowright	[('all the performances', 'performances', 'nsubj', 'are'), ('first-rate', 'rate', 'attr', 'are')]
It says something when Miranda Richardson does her usual fine work and yet is overshadowed by so many others in the cast	[('It', 'It', 'nsubj', 'says'), ('something', 'something', 'dobj', 'says'), ('Miranda Richardson', 'Richardson', 'nsubj', 'does'), ('her usual fine work', 'work', 'dobj', 'does'), ('so many others', 'others', 'pobj', 'by'), ('the cast', 'cast', 'pobj', 'in')]
Most highly recommended, particularly if you are a romantic at heart	[('you', 'you', 'nsubj', 'are'), ('heart', 'heart', 'pobj', 'at')]
Director / writer Michael Winner's feature is a better than expected offbeat supernatural horror film (although still schlock efficiently catered for), which really does by go unnoticed	[("Director / writer Michael Winner's feature", 'feature', 'nsubj', 'is'), ('offbeat supernatural horror film', 'film', 'dobj', 'expected')]
Sure it might borrow ideas from other similar themed horror movies of this period, but still manages to bring its own psychological imprint to the smokescreen material (of good vs	[('it', 'it', 'nsubj', 'borrow'), ('ideas', 'ideas', 'dobj', 'borrow'), ('other similar themed horror movies', 'movies', 'pobj', 'from'), ('this period', 'period', 'pobj', 'of'), ('its own psychological imprint', 'imprint', 'dobj', 'bring'), ('the smokescreen material', 'material', 'pobj', 'to'), ('good', 'good', 'pobj', 'of')]
evil) and a unique vision that has a fair share of impressively expansive, if somewhat exploitative set-pieces	[('a unique vision', 'vision', 'conj', 'evil'), ('a fair share', 'share', 'dobj', 'has'), ('set-pieces', 'pieces', 'dobj', 'exploitative')]
As a whole it's sketchy, however remains intriguing by instilling an ominous charge without going gang-busters with the scares	[('a whole', 'whole', 'pobj', 'As'), ('it', 'it', 'nsubj', "'s"), ('an ominous charge', 'charge', 'dobj', 'instilling'), ('gang-busters', 'busters', 'dobj', 'going'), ('the scares', 'scares', 'pobj', 'with')]
Actually there's always something going on amongst its busy framework, but it's rather down-played with its shocks steering to soapy patterns and atmospheric tailoring, up until its vividly repellent and grisly climax with a downbeat revelation	[('something', 'something', 'attr', "'s"), ('its busy framework', 'framework', 'pobj', 'amongst'), ('it', 'it', 'nsubj', "'s"), ('its shocks', 'shocks', 'pobj', 'with'), ('soapy patterns', 'patterns', 'pobj', 'to'), ('atmospheric tailoring', 'tailoring', 'conj', 'patterns'), ('a downbeat revelation', 'revelation', 'pobj', 'with')]
Winner's dressed up craftsmanship might feel pedestrian, however it's the ensemble cast that really holds it together as you try to spot the faces	[('Winner', 'Winner', 'nsubj', 'dressed'), ('craftsmanship', 'craftsmanship', 'nsubj', 'feel'), ('pedestrian', 'pedestrian', 'dobj', 'feel'), ('it', 'it', 'nsubj', "'s"), ('the ensemble cast', 'cast', 'attr', "'s"), ('it', 'it', 'dobj', 'holds'), ('you', 'you', 'nsubj', 'try'), ('the faces', 'faces', 'dobj', 'spot')]
Some having more to do with the scheme of things than others, but there's no doubts every one of them are committed, despite the ludicrously crude nature of it all	[('the scheme', 'scheme', 'pobj', 'with'), ('things', 'things', 'pobj', 'of'), ('others', 'others', 'pobj', 'than'), ('no doubts', 'doubts', 'attr', "'s"), ('them', 'them', 'pobj', 'of'), ('the ludicrously crude nature', 'nature', 'pobj', 'despite'), ('it', 'it', 'pobj', 'of')]
It's interesting to see names like Sylvia Miles (who's significantly creepy!), Beverly D'Angelo (likewise), Deborah Raffin, Eli Wallach, Christopher Walken, William Hickey (a neat cameo), Jeff Goldblum, Jerry Orbach and Tom Berenger in bit parts	[('It', 'It', 'nsubj', "'s"), ('names', 'names', 'dobj', 'see'), ('Sylvia Miles', 'Miles', 'pobj', 'like'), ('who', 'who', 'nsubj', "'s"), ("Beverly D'Angelo", "D'Angelo", 'appos', 'who'), ('Deborah Raffin', 'Raffin', 'conj', "D'Angelo"), ('Eli Wallach', 'Wallach', 'conj', 'Raffin'), ('Christopher Walken', 'Walken', 'conj', 'Wallach'), ('William Hickey', 'Hickey', 'conj', 'Walken'), ('a neat cameo', 'cameo', 'appos', 'Hickey'), ('Jeff Goldblum', 'Goldblum', 'conj', "D'Angelo"), ('Jerry Orbach', 'Orbach', 'conj', 'Goldblum'), ('Tom Berenger', 'Berenger', 'conj', 'Orbach'), ('bit parts', 'parts', 'pobj', 'in')]
Then you got a mild-mannered Chris Sarandon and movingly gorgeous Cristina Raines in the leads	[('you', 'you', 'nsubj', 'got'), ('a mild-mannered Chris Sarandon', 'Sarandon', 'dobj', 'got'), ('movingly gorgeous Cristina Raines', 'Raines', 'conj', 'Sarandon'), ('the leads', 'leads', 'pobj', 'in')]
Offering able support José Ferrer, Martin Balsam, Ava Gardner, John Carradine, Burgess Meredith and Arthur Kennedy	[('able support José Ferrer', 'Ferrer', 'dobj', 'Offering'), ('Martin Balsam', 'Balsam', 'appos', 'Ferrer'), ('Ava Gardner', 'Gardner', 'conj', 'Balsam'), ('John Carradine', 'Carradine', 'conj', 'Gardner'), ('Burgess Meredith', 'Meredith', 'conj', 'Carradine'), ('Arthur Kennedy', 'Kennedy', 'conj', 'Meredith')]
The script does throw around many characters, as well as notions but gets disjointedly sidetrack by trying to squeeze all of it in	[('The script', 'script', 'nsubj', 'throw'), ('many characters', 'characters', 'dobj', 'throw'), ('notions', 'notions', 'conj', 'characters'), ('it', 'it', 'pobj', 'of')]
However it's disorienting air works in its favour in establishing the suspicion and deception of what's really going on here	[('it', 'it', 'nsubj', 'disorienting'), ('its favour', 'favour', 'pobj', 'in'), ('the suspicion', 'suspicion', 'dobj', 'establishing'), ('deception', 'deception', 'conj', 'suspicion'), ('what', 'what', 'nsubj', 'going')]
Is there a reason for all of this, and why is it surrounding Raines' character? The emphasis is mainly built upon that moody angle, as it begins to slowly shed light of her inner goings and that of the strange/worrying experiences she encounters when she's moves into her new apartment	[('a reason', 'reason', 'attr', 'Is'), ('it', 'it', 'nsubj', 'surrounding'), ("Raines' character", 'character', 'dobj', 'surrounding'), ('The emphasis', 'emphasis', 'nsubjpass', 'built'), ('that moody angle', 'angle', 'pobj', 'upon'), ('it', 'it', 'nsubj', 'begins'), ('light', 'light', 'dobj', 'shed'), ('her inner goings', 'goings', 'pobj', 'of'), ('the strange/worrying experiences', 'experiences', 'pobj', 'of'), ('she', 'she', 'nsubj', 'encounters'), ('she', 'she', 'nsubj', "'s"), ('moves', 'moves', 'attr', "'s"), ('her new apartment', 'apartment', 'pobj', 'into')]
This is where Winner tries to pull out the eerie shades, which projects some icy moments	[('Winner', 'Winner', 'nsubj', 'tries'), ('the eerie shades', 'shades', 'dobj', 'pull'), ('some icy moments', 'moments', 'dobj', 'projects')]
Gil Melle was the man responsible for the grand, overpowering orchestral score that never misses a cue and Richard C	[('Gil Melle', 'Melle', 'nsubj', 'was'), ('the man', 'man', 'attr', 'was'), ('orchestral score', 'score', 'dobj', 'overpowering'), ('a cue', 'cue', 'dobj', 'misses'), ('Richard C', 'C', 'conj', 'cue')]
Kratina instruments the sweeping, scope-like photography	[('Kratina', 'Kratina', 'nsubj', 'instruments'), ('the sweeping, scope-like photography', 'photography', 'dobj', 'instruments')]
William (Nicholas Ball) and Emma Peters (Rachel Davies) buy an old house where a brutal murder happened years ago in very bad condition with the intention of restoring it	[('William', 'William', 'nsubj', 'buy'), ('Nicholas Ball', 'Ball', 'appos', 'William'), ('Emma Peters', 'Peters', 'conj', 'William'), ('Rachel Davies', 'Davies', 'appos', 'Peters'), ('an old house', 'house', 'dobj', 'buy'), ('a brutal murder', 'murder', 'nsubj', 'happened'), ('very bad condition', 'condition', 'pobj', 'in'), ('the intention', 'intention', 'pobj', 'with'), ('it', 'it', 'dobj', 'restoring')]
They move with their daughter Sophie (Emma RidleY), and become friends of their neighbors Jean (Patricia Maynard) and George Evans (Brian Croucher)	[('They', 'They', 'nsubj', 'move'), ('their daughter', 'daughter', 'pobj', 'with'), ('Sophie', 'Sophie', 'appos', 'daughter'), ('(Emma RidleY', 'RidleY', 'appos', 'Sophie'), ('friends', 'friends', 'attr', 'become'), ('their neighbors', 'neighbors', 'pobj', 'of'), ('Jean', 'Jean', 'appos', 'neighbors'), ('Patricia Maynard', 'Maynard', 'appos', 'Jean'), ('George Evans', 'Evans', 'conj', 'friends'), ('(Brian Croucher', 'Croucher', 'appos', 'Evans')]
However, eerie events happen in the house, inclusive the death of Sophie's cat	[('eerie events', 'events', 'nsubj', 'happen'), ('the house', 'house', 'pobj', 'in'), ('the death', 'death', 'dobj', 'inclusive'), ("Sophie's cat", 'cat', 'pobj', 'of')]
In Sophie's birthday party, a pipe leaks blood and they leave the place, disclosing a secret later	[("Sophie's birthday party", 'party', 'pobj', 'In'), ('they', 'they', 'nsubj', 'leave'), ('the place', 'place', 'dobj', 'leave'), ('a secret', 'secret', 'dobj', 'disclosing')]
<br /><br />"The House That Bled to Death" is a scary and one of the best episodes of the series "Hammer House of Horror"	[('House', 'House', 'nsubj', 'is'), ('Death', 'Death', 'pobj', 'to'), ('the best episodes', 'episodes', 'pobj', 'of'), ('the series', 'series', 'pobj', 'of'), ('Hammer House', 'House', 'appos', 'series'), ('Horror', 'Horror', 'pobj', 'of')]
The fantastic twist, disclosing a secret, and the tragic conclusion are really excellent	[('The fantastic twist', 'twist', 'nsubj', 'are'), ('a secret', 'secret', 'dobj', 'disclosing'), ('the tragic conclusion', 'conclusion', 'nsubj', 'are')]
<br /><br />Title (Brazil): "A Casa Que Sangrou Até Morrer" ("The House That Bled to Death"	[('(Brazil', 'Brazil', 'ROOT', 'Brazil'), (': "A Casa Que Sangrou Até Morrer', 'Morrer', 'appos', 'Brazil'), ('The House', 'House', 'appos', 'Morrer'), ('Death', 'Death', 'pobj', 'to')]
Kubrick proved his brilliantness again, now in a suspense-horror film based on Stephen King's book titled the same way	[('Kubrick', 'Kubrick', 'nsubj', 'proved'), ('a suspense-horror film', 'film', 'pobj', 'in'), ("Stephen King's book", 'book', 'pobj', 'on')]
Jack Torrance is a man in his forties, married, with one child, and with a past of trouble and alcoholism	[('Jack Torrance', 'Torrance', 'nsubj', 'is'), ('a man', 'man', 'attr', 'is'), ('his forties', 'forties', 'pobj', 'in'), ('one child', 'child', 'pobj', 'with'), ('a past', 'past', 'pobj', 'with'), ('trouble', 'trouble', 'pobj', 'of'), ('alcoholism', 'alcoholism', 'conj', 'trouble')]
